{\rtf1\ansi\ansicpg1252\cocoartf2822
\cocoatextscaling0\cocoaplatform0{\fonttbl\f0\fswiss\fcharset0 Helvetica;}
{\colortbl;\red255\green255\blue255;}
{\*\expandedcolortbl;;}
\margl1440\margr1440\vieww11520\viewh8400\viewkind0
\pard\tx720\tx1440\tx2160\tx2880\tx3600\tx4320\tx5040\tx5760\tx6480\tx7200\tx7920\tx8640\pardirnatural\partightenfactor0

\f0\fs24 \cf0 aberration = ab-er-AY-shun | Deviation from what is expected or typical in data or behavior.\
abstraction = ab-STRACK-shun | Mental process of generalizing concepts beyond specific examples.\
accuracy = ACK-yur-ah-see | Degree to which a measurement reflects the true value.\
acquisition = ack-wi-ZIH-shun | Initial learning of a behavior or skill.\
adaptation = uh-DAP-tay-shun | Trait shaped by natural selection to improve fitness.\
aggregate data = AG-rih-gut DAY-tuh | Combined data summarized across participants or trials.\
algorithm = AL-go-rith-um | Rule-based procedure for solving a problem.\
analysis = uh-NAL-ih-siss | Systematic examination of data or phenomena.\
annotation = ann-oh-TAY-shun | Explanatory note or comment.\
applied research = uh-PLIDE ree-SURCH | Research aimed at solving practical problems.\
approximation = uh-PROCK-sih-MAY-shun | Estimate close to an exact value.\
archival data = ar-KAI-vull DAY-tuh | Preexisting datasets collected for other purposes.\
artifact = AR-tih-fact | Distortion or error introduced by method or measurement.\
assessment = uh-SESS-ment | Evaluation of skills, traits, or performance.\
association = uh-SO-see-AY-shun | Statistical relationship between variables.\
asymptote = ASS-im-toht | Stable value a function approaches.\
attenuation = uh-TEN-yoo-AY-shun | Reduction in strength or intensity of a signal or effect.\
baseline = BASE-line | Initial reference point for comparison.\
bias = BYE-us | Systematic deviation from truth in measurement or reasoning.\
catalyst = CAT-uh-list | Agent that speeds up a reaction or process.\
causal inference = CAW-zul IN-furr-ence | Determining causal relations between variables.\
causation = kaw-ZAY-shun | Relationship where one event produces another.\
central tendency = SEN-trull TEN-dun-see | Typical value in a dataset (mean, median, mode).\
classification = class-ih-fih-KAY-shun | Grouping objects based on shared features.\
coding scheme = KOH-ding skeem | Rules for categorizing qualitative data.\
coefficient = koh-EFF-ish-ee-ent | Numerical index representing relationship strength.\
cohort = KO-hort | Group sharing a common demographic characteristic.\
comparative method = com-PARE-uh-tiv METH-ud | Comparing groups or species to infer patterns.\
competence = KOM-pih-tence | Ability to perform a skill or solve a problem.\
compliance = kom-PLY-uns | Conformity with instructions or rules.\
confound = KON-fownd | Variable that distorts causal interpretation.\
consistency = kon-SISS-ten-see | Stability or uniformity in measurement or behavior.\
construct = KON-struct | Abstract psychological concept.\
construct validity = KON-struct vuh-LID-ih-tee | Extent a measure reflects the intended construct.\
control group = con-TROLE groop | Baseline group in experiments with no manipulation.\
convergent evidence = kon-VER-jent EHV-ih-dence | Findings from multiple methods supporting a conclusion.\
correlation = core-uh-LAY-shun | Statistical relation between variables.\
criterion = cry-TEER-ee-un | Standard for evaluating accuracy or performance.\
critical review = KRIT-ih-kull ree-VYOO | Analytical evaluation of research.\
data point = DAY-tuh point | Individual unit of data.\
data set = DAY-tuh set | Collection of related data.\
deduction = dee-DUCK-shun | Reasoning from general principles to specific predictions.\
descriptive statistics = de-SKRIP-tiv stuh-TISS-ticks | Summaries describing data features.\
differentiation = diff-er-en-SHEE-AY-shun | Distinguishing among similar elements.\
discrepancy = dis-KREP-un-see | Difference between expected and observed outcomes.\
distribution = diss-trih-BYOO-shun | Pattern of values across a dataset.\
effect size = ee-FEKT size | Magnitude of a relationship or difference.\
empirical = em-PEER-ih-kull | Based on observation or data.\
estimation = ess-tih-MAY-shun | Inferring values from data.\
ethics = ETH-icks | Principles guiding research conduct.\
evaluation = ee-VAL-yoo-AY-shun | Systematic appraisal of performance or evidence.\
evidence base = EHV-ih-dence base | Research supporting a method or conclusion.\
experimental design = ex-PAIR-ih-men-tul de-ZINE | Structure determining how studies are conducted.\
explanatory model = ex-PLAN-uh-tor-ee MAW-dull | Conceptual framework explaining relationships.\
extrapolation = ex-STRAP-oh-LAY-shun | Inferring beyond observed data.\
false positive = FALLS PAWZ-ih-tiv | Incorrectly identifying an effect.\
false negative = FALLS NEG-uh-tiv | Failure to detect a real effect.\
feasibility = FEE-zuh-bill-ih-tee | Practical viability of a method or study.\
generalization = jen-er-uh-lie-ZAY-shun | Applying findings to broader contexts.\
heuristic = hyoo-RISS-tick | Mental shortcut for quick decision making.\
hypothesis = hy-POTH-uh-siss | Testable prediction.\
ideation = eye-dee-AY-shun | Generation of ideas or concepts.\
implementation = im-pleh-men-TAY-shun | Putting a plan or method into action.\
inference = IN-furr-ence | Logical conclusion based on evidence.\
instrumentation = in-struh-men-TAY-shun | Tools used to collect data.\
interaction effect = in-ter-ACK-shun ee-FEKT | Combined influence of variables.\
internal validity = in-TERN-ul vuh-LID-ih-tee | Confidence that manipulation caused observed effects.\
interpretation = in-TER-prih-TAY-shun | Making sense of results.\
inverse relation = IN-vers ree-LAY-shun | Negative correlation between variables.\
iteration = it-er-AY-shun | Repetition for refinement.\
latent construct = LAY-tent KON-struct | Hidden psychological trait inferred from data.\
literature review = LIT-er-uh-chur ree-VYOO | Survey of existing scholarship.\
manipulation = muh-NIP-yoo-LAY-shun | Experimental change applied to conditions.\
mediator = MEE-dee-ay-tor | Variable explaining the relation between two others.\
meta-analysis = MET-uh uh-NAL-iss-iss | Statistical combination of results across studies.\
methodology = meth-uh-DOLL-oh-jee | Study design and procedures.\
model comparison = MAW-dull com-PAIR-ih-sun | Evaluating competing models.\
multimodal data = mull-tee-MOH-dull DAY-tuh | Data from multiple methods or measures.\
normative data = NOR-muh-tiv DAY-tuh | Standardized reference values.\
null hypothesis = NULL hy-POTH-uh-siss | Assumption of no effect.\
observation = ob-zer-VAY-shun | Direct measurement through watching or recording.\
operational definition = op-er-AY-shun-ul deh-fih-NISH-un | Concrete specification of a concept.\
optimization = op-tih-mih-ZAY-shun | Enhancing efficiency or performance.\
parameter = puh-RAM-ih-tur | Numerical characteristic of a population.\
peer review = PEER ree-VYOO | Evaluation by experts in the field.\
population = pop-yoo-LAY-shun | Larger group from which samples are drawn.\
predictor variable = preh-DICK-tor VEHR-ee-uh-bull | Variable used to forecast outcomes.\
probability = pro-buh-BILL-ih-tee | Likelihood of an event.\
protocol = PRO-tuh-call | Standardized procedure.\
qualitative data = KWAH-luh-tay-tiv DAY-tuh | Non-numerical descriptive data.\
quantitative data = KWAN-tuh-tay-tiv DAY-tuh | Numerical information.\
randomization = ran-doh-mih-ZAY-shun | Assigning conditions by chance.\
range = RANGE | Spread between highest and lowest values.\
reactivity = ree-ak-TIV-ih-tee | Behavior changes due to being observed.\
reliability = ree-LIE-uh-BILL-ih-tee | Consistency of measurement.\
replication = rep-lih-KAY-shun | Repetition of a study for verification.\
sample = SAMP-ull | Subset of a population.\
sampling bias = SAMP-ling BYE-us | Nonrepresentative sampling error.\
scatterplot = SKAT-er-plot | Graph of paired data points.\
significance = sig-NIFF-ih-kunce | Statistical evidence against the null hypothesis.\
standard deviation = STAN-derd dee-vee-AY-shun | Average dispersion of scores.\
statistical power = stuh-TISS-tih-kul POW-er | Probability of detecting an effect.\
survey = SIR-vay | Self-report data collection tool.\
systematic review = sis-teh-MAT-ick ree-VYOO | Comprehensive analysis of evidence.\
triangulation = try-ang-yoo-LAY-shun | Integrating multiple perspectives or methods.\
validity = vuh-LID-ih-tee | Accuracy of a measure or inference.\
variance = VAIR-ee-unce | Spread of data around the mean.\
weighted mean = WAY-ted meen | Average adjusted by weights.\
}