{\rtf1\ansi\ansicpg1252\cocoartf2822
\cocoatextscaling0\cocoaplatform0{\fonttbl\f0\fswiss\fcharset0 Helvetica;}
{\colortbl;\red255\green255\blue255;}
{\*\expandedcolortbl;;}
\margl1440\margr1440\vieww11520\viewh8400\viewkind0
\pard\tx720\tx1440\tx2160\tx2880\tx3600\tx4320\tx5040\tx5760\tx6480\tx7200\tx7920\tx8640\pardirnatural\partightenfactor0

\f0\fs24 \cf0 aberrant behavior	[AB-err-ant]	Behavior deviating from expected species-typical patterns.\
abiotic pressure	[ay-BYE-oh-tick]	Nonliving environmental forces shaping selection.\
absolute fitness	[AB-so-loot FIT-ness]	Total reproductive success of an organism.\
acoustic signaling	[ah-KOO-stik SIG-nuh-ling]	Communication via sound in animals.\
actuarial risk	[ak-CHOO-air-ee-uhl risk]	Probability of adverse developmental or behavioral outcomes.\
adaptive advantage	[ah-DAP-tiv ad-VAN-tij]	Trait\'92s contribution to survival or reproduction.\
adaptive calibration	[ah-DAP-tiv kal-ih-BRAY-shun]	Tuning of behavior to environmental conditions.\
adaptive flexibility	[ah-DAP-tiv FLEK-sih-bill-ih-tee]	Ability to adjust behaviors in shifting contexts.\
adaptive latency	[ah-DAP-tiv LAY-ten-see]	Delay in response that increases fitness under certain pressures.\
adaptive plasticity	[ah-DAP-tiv PLAS-tiss-ih-tee]	Capacity to adjust behavior or physiology in response to experience.\
adversarial threat	[ad-ver-SAIR-ee-uhl THRET]	Environmental or social source of danger.\
affective valence	[ah-FEK-tiv VAY-lence]	Emotional positivity or negativity associated with stimuli.\
affiliative grimace	[ah-FILL-ee-ah-tiv GRIM-iss]	Submissive facial expression used to reduce conflict.\
agonistic behavior	[ag-oh-NISS-tik]	Conflict-related behavior such as threat or submission.\
alarm calling	[ah-LARM CALL-ing]	Warning signal given to conspecifics.\
allogrooming	[AL-oh-GROO-ming]	Grooming another individual for social bonding.\
allomothering	[AL-oh-MUH-ther-ing]	Care of young by non-mothers.\
altricial species	[al-TRISH-uhl]	Species born helpless requiring extensive parental care.\
altruistic behavior	[al-TROO-iss-tik]	Cooperative acts benefiting others at personal cost.\
amygdala	[uh-MIG-duh-luh]	Limbic structure central to fear, threat detection, and emotion.\
amygdala reactivity	[uh-MIG-duh-luh ree-AK-tiv-it-ee]	Sensitivity of amygdala to threat cues.\
ancestral environment	[an-SESS-tral en-VYE-run-ment]	Evolutionary conditions that shaped adaptation.\
ancestral fear module	[an-SESS-tral FEER MOD-yool]	Rapid, evolved system for detecting danger.\
androgen exposure	[AN-droh-jen ex-POH-zher]	Hormonal influence shaping development and behavior.\
animal personality	[AN-ih-muhl per-suh-NAL-ih-tee]	Stable behavioral differences across individuals.\
anticipatory stress response	[an-TISS-ih-pay-tor-ee STRESS ree-SPONSS]	Preparing physiologically for predicted threat.\
anticipatory vigilance	[an-TISS-ih-pay-tor-ee VIH-jih-lens]	Monitoring for potential threats before they occur.\
anterior cingulate cortex	[an-TEER-ee-or SING-gyoo-lit CORE-tecks]	Region involved in conflict detection and affect regulation.\
attachment asymmetry	[ah-TACH-ment ay-SIM-et-tree]	Uneven relational security across caregivers.\
attachment distress	[ah-TACH-ment dis-TRESS]	Arousal triggered by separation or relational conflict.\
attachment plasticity	[ah-TACH-ment PLAS-tiss-ih-tee]	Flexibility of attachment responses over time.\
attachment proximity seeking	[ah-TACH-ment PROCK-sim-it-ee SEEK-ing]	Behavior aimed at maintaining closeness to attachment figures.\
attachment strategies	[ah-TACH-ment STRA-tuh-jeez]	Adaptive patterns regulating closeness and security.\
auditory cognition	[AW-dih-tor-ee kog-NIH-shun]	Processing and interpretation of sound information.\
aversive conditioning	[ah-VER-siv kun-DISH-un-ing]	Learning via negative or unpleasant stimuli.\
avoidance hierarchy	[ah-VOY-dens HI-er-ark-ee]	Ordered sequence of avoidance responses.\
barking repertoires	[BAR-king REP-er-twahrz]	Full range of bark types used by dogs.\
basal ganglia	[BAY-zul GANG-lee-uh]	Subcortical nuclei involved in reward, learning, and movement.\
baseline threat sensitivity	[BASE-line THRET sen-sih-TIV-ih-tee]	Default vigilance to danger cues.\
behavioral asymmetry	[bee-HAY-vyer-uhl ay-SIM-et-tree]	Imbalanced behavioral responses across contexts.\
behavioral contagion	[bee-HAY-vyer-uhl kon-TAY-jun]	Spread of behavior across individuals.\
behavioral decoupling	[bee-HAY-vyer-uhl dee-KUP-ling]	Acting independently from emotional arousal.\
behavioral ecology	[bee-HAY-vyer-uhl ee-KOL-oh-jee]	Evolutionary analysis of behavior in ecological context.\
behavioral entrainment	[bee-HAY-vyer-uhl en-TRAIN-ment]	Synchronizing behavior to external rhythms.\
behavioral flexibility	[bee-HAY-vyer-uhl FLEK-sih-bill-ih-tee]	Ability to modify actions based on context.\
behavioral immunization	[bee-HAY-vyer-uhl ih-MYOO-nih-ZAY-shun]	Resilience gained via manageable stress exposure.\
behavioral inhibition	[bee-HAY-vyer-uhl in-HIB-ih-shun]	Tendency to withdraw from novelty or threat.\
behavioral latency	[bee-HAY-vyer-uhl LAY-ten-see]	Time delay before behavioral response.\
behavioral lateralization	[bee-HAY-vyer-uhl lat-er-uh-LY-zay-shun]	Asymmetries in behavior linked to brain hemisphere specialization.\
behavioral modulation	[bee-HAY-vyer-uhl mod-yoo-LAY-shun]	Adjustment of behavior to internal or external cues.\
behavioral phenotype	[bee-HAY-vyer-uhl FEE-noh-type]	Behavioral expression shaped by genetic and environmental factors.\
behavioral renormalization	[bee-HAY-vyer-uhl ree-NOR-mal-eye-ZAY-shun]	Returning behavior to adaptive levels.\
behavioral synchrony	[bee-HAY-vyer-uhl SING-kruh-nee]	Coordinated timing of actions between individuals.\
behavioral thermoregulation	[bee-HAY-vyer-uhl ther-moh-REG-yoo-lay-shun]	Behavior used to regulate temperature.\
behavioral trade-off	[bee-HAY-vyer-uhl TRADE-off]	Balancing competing behavioral demands.\
benefit\'96cost ratio	[BEN-eh-fit COST ray-shee-oh]	Fitness balance of benefits minus costs.\
belyaev domestication hypothesis	[bel-YAH-ev doh-MESS-tih-KAY-shun hy-POTH-eh-sis]	Tameness selection drives morphological and behavioral change.\
biobehavioral threat system	[bye-oh-beh-HAY-vyer-uhl THRET SIS-tem]	Integrated neural + hormonal defense network.\
bioenergetic load	[bye-oh-en-er-JET-ik LOHD]	Metabolic cost of a trait or behavior.\
biological preparedness	[bye-oh-LOJ-ick-uhl pre-PAIR-ed-ness]	Evolutionary readiness to learn certain associations.\
biotic resource	[bye-AH-tick REE-sorse]	Living component of an ecosystem.\
bond degradation	[BOND deg-ruh-DAY-shun]	Erosion of relational security.\
bonding circuitry	[BOND-ing SIR-kuht-ree]	Neural systems involved in attachment.\
bottom-up processing	[BOT-um UP pross-ess-ing]	Sensory-driven information flow.\
breed-specific behavior	[BREED-spih-SIFF-ik]	Characteristic tendencies of a lineage or breed.\
brood parasitism	[BROOD PAIR-uh-sit-iz-um]	Reproductive strategy outsourcing parental care.\
buffering mechanism	[BUFF-er-ing MEH-kuh-niz-um]	Process preventing negative effects.\
canid cognition	[KAY-nid kog-NIH-shun]	Mental processes in dogs, wolves, foxes.\
canid neoteny	[KAY-nid nee-OT-en-ee]	Retention of juvenile traits into adulthood.\
canine attachment	[KAY-nine ah-TACH-ment]	Dog\'96human bonding system.\
canine attachment asymmetry	[KAY-nine ah-TACH-ment ay-SIM-et-tree]	Uneven attachment across caregivers.\
canine attentional bias	[KAY-nine uh-TEN-shun-al BYE-uss]	Preferential attention to certain cues.\
canine cooperative communication	[KAY-nine koh-OP-er-uh-tiv kom-yoo-nih-KAY-shun]	Dog\'96human joint-action signaling.\
canine displacement behavior	[KAY-nine DIS-place-ment beh-HAY-vyer]	Stress behaviors such as yawning or shaking.\
canine dominance ambiguity	[KAY-nine DOM-ih-nens am-BIG-yoo-ih-tee]	Context-dependent rank relationships.\
canine gaze alternation	[KAY-nine GAYZ alt-er-NAY-shun]	Switching gaze between human and object to request assistance.\
canine helping behavior	[KAY-nine HELP-ing]	Prosocial actions directed at social partners.\
canine hyperfocus	[KAY-nine HY-per-FOH-kuss]	Intensified attention toward a stimulus.\
canine hypersociability	[KAY-nine HY-per-SOH-shuh-BILL-ih-tee]	Elevated affiliative behavior typical in domesticated dogs.\
canine prosociality	[KAY-nine pro-SOH-shal-it-ee]	Positive social behavior toward dogs or humans.\
canine reactivity	[KAY-nine ree-AK-tiv-it-ee]	Intensity of dog\'92s emotional responses.\
canine social referencing	[KAY-nine SOH-shul REF-er-en-sing]	Using human emotional cues for decision-making.\
canine threat calibration	[KAY-nine THRET kal-ih-BRAY-shun]	Adjusting vigilance to context.\
caregiver-specific valence	[CARE-giv-er spih-SIFF-ik VAY-lence]	Emotion tied to specific attachment figures.\
cerebellum	[sair-uh-BELL-um]	Structure coordinating balance, motor learning, and movement precision.\
cerebral cortex	[suh-REE-brull CORE-tecks]	Brain\'92s outer layer for cognition and planning.\
chemical communication	[KEM-ih-kul kom-yoo-nih-KAY-shun]	Signaling via scent molecules.\
clan-level cohesion	[CLAN-level koh-HEE-zhun]	Strength of bonds within multi-dog or multi-human groups.\
classical conditioning	[KLASS-ih-kul kun-DISH-un-ing]	Learning associations between neutral and meaningful stimuli.\
climate-related selection	[KLY-mit ree-LAY-ted sel-ECK-shun]	Environmental pressures tied to weather patterns.\
cognitive bias	[KOG-nih-tiv BYE-uss]	Systematic pattern of thinking that affects decisions.\
cognitive dissonance	[KOG-nih-tiv DISS-oh-nens]	Conflict between beliefs or expectations.\
cognitive ecology	[KOG-nih-tiv ee-KOL-oh-jee]	Study of cognitive traits shaped by environment.\
cognitive flexibility	[KOG-nih-tiv FLEK-sih-bill-ih-tee]	Ability to switch strategies or perspectives.\
cognitive inhibition	[KOG-nih-tiv in-HIB-ih-shun]	Suppressing irrelevant information.\
cognitive load	[KOG-nih-tiv LOHD]	Mental effort required by a task.\
cognitive mapping	[KOG-nih-tiv MAP-ing]	Internal representation of spatial layout.\
cognitive niche	[KOG-nih-tiv NEECH]	Environment constructed through cognitive abilities.\
cognitive offloading	[KOG-nih-tiv OFF-load-ing]	Using environment/tools to reduce mental burden.\
cognitive specialization	[KOG-nih-tiv spesh-uhl-eye-ZAY-shun]	Evolution of domain-specific cognitive abilities.\
conflict-induced ambivalence	[KON-flikt in-DOOST am-BIV-uh-lens]	Mixed motivational states after threat.\
conscious awareness	[KON-shuss uh-WAIR-ness]	Ability to process information with reflection.\
conspecific play arc	[kon-SPESS-ih-fik PLAY ark]	Typical sequence of play behaviors.\
conspecific recognition	[kon-SPESS-ih-fik REK-ug-NIH-shun]	Identifying members of same species.\
contextual fear learning	[kon-TEKS-choo-ul FEER LERN-ing]	Learning threat based on environment.\
contingent affiliative cue	[kun-TIN-jent ah-FILL-ee-ah-tiv KYOO]	Social signal dependent on relational context.\
counterpredatory strategies	[COUNT-er-PREH-dah-tor-ee STRA-tuh-jeez]	Actions reducing predator advantage.\
corpus callosum	[CORE-pus kah-LOW-sum]	Fiber tract connecting brain hemispheres.\
cortisol reactivity	[KOR-tih-sol ree-AK-tiv-it-ee]	Hormonal response to stress.\
cue competition	[KYOO kom-peh-TIH-shun]	Cues interfere in predicting outcomes.\
cue salience	[KYOO SAY-lee-ens]	Noticeability or prominence of a signal.\
cultural transmission	[KULL-chur-al tranz-MISS-shun]	Passing behavior socially across generations.\
curiosity drive	[KYOO-ree-AH-sih-tee DRYV]	Motivation to explore and seek new information.\
cyclic threat pattern	[SYE-klik THRET PAT-ern]	Recurring fluctuations in danger level.\
danger gradient mapping	[DANE-jer GRAY-dee-ent MAP-ping]	Tracking spatial variation in threat intensity.\
decision latency	[deh-SIH-zhun LAY-ten-see]	Delay before choosing between alternatives.\
deep homology	[DEEP hah-MOL-oh-jee]	Shared genetic and developmental origins across species.\
defensive aggression	[deh-FEN-siv ag-GRESH-un]	Aggression triggered by fear or threat.\
defensive posturing	[deh-FEN-siv POS-chur-ing]	Body signals preparing for protection.\
deferred imitation	[deh-FERD ih-MAY-shun]	Copying behavior after delay.\
deferred punishment sensitivity	[deh-FERD PUN-ish-ment sen-sih-TIV-it-ee]	Responsiveness to consequences that are delayed.\
delayed reinforcement	[deh-LAYD re-in-FORSS-ment]	Reward occurring after the behavior.\
developmental fear pruning	[deh-VEL-op-ment-uhl FEER PROON-ing]	Reduction of early fear responses with experience.\
developmental plasticity	[deh-VEL-op-ment-uhl PLAS-tiss-ih-tee]	Capacity for changing traits across development.\
differential reinforcement of calm	[DIF-fer-EN-shul re-in-FORSS-ment of CALM]	Reinforcing low-arousal states.\
differential susceptibility	[DIF-fer-EN-shul suh-SEP-tuh-bill-it-ee]	Sensitivity to good and bad environments.\
direct reciprocity	[di-REKT reh-sih-PROCK-ih-tee]	Cooperation based on repeated interactions.\
disclosure effect	[dis-KLO-zher eh-FEKT]	Increased trust after revealing information.\
displacement activity	[dis-PLACE-ment ak-TIV-it-ee]	Behavior expressing conflict, stress, or inhibition.\
distance\'96rule conflict	[DIS-tens ROOL KON-flikt]	Tension between distance and social bonding.\
distributed cognition	[dis-TRIB-yoo-ted kog-NIH-shun]	Thinking spread across individuals and environment.\
dog\'96human co-regulation	[DOG HYOO-man koh-reg-yoo-LAY-shun]	Human-supported emotional regulation in dogs.\
dominance hierarchy	[DOM-ih-nens HI-er-ark-ee]	Ranked order of power or access among individuals.\
dopamine	[DOPE-uh-meen]	Neurotransmitter for reward, motivation, reinforcement learning.\
downregulation	[DOWN-reg-yoo-LAY-shun]	Reduction of emotional or physiological intensity.\
dual-process theory	[DOO-ul PROS-ess THEE-ree]	Two interacting systems: fast automatic and slow controlled.\
dynamic social signaling	[dye-NAM-ik SOH-shul SIG-nuh-ling]	Flexible expression of communication cues.\
ecological grief	[ee-koh-LOJ-ik-uhl GREEF]	Emotional distress from environmental degradation.\
ecological intelligence	[ee-koh-LOJ-ik-uhl in-TELL-ih-jens]	Cognition specialized for environmental demands.\
ecological niche	[ee-koh-LOJ-ik-uhl NEECH]	Ecological role a species occupies.\
ecological validity	[ee-koh-LOJ-ik-uhl vah-LID-it-ee]	How well findings generalize to real world.\
eco-social trade-off	[EE-koh SOH-shul TRADE-off]	Balancing ecology and social demands.\
effect size	[eh-FEKT SIZE]	Magnitude of an observed relationship.\
emotion contagion	[ee-MOH-shun kon-TAY-jun]	Spread of affect across individuals.\
emotion\'96action decoupling	[ee-MOH-shun AK-shun dee-KUP-ling]	Inhibiting action despite emotional arousal.\
emotional buffering	[ee-MOH-shun-al BUFF-er-ing]	Reducing stress through supportive presence.\
emotional reactivity	[ee-MOH-shun-al ree-AK-tiv-it-ee]	Intensity of emotional responses.\
endogenous attention	[en-DAH-juh-nus uh-TEN-shun]	Internally driven focus.\
environmental affordances	[en-VYE-run-men-tal uh-FORD-ens-ez]	Opportunities for action in environment.\
epigenetic inheritance	[ep-ih-jeh-NET-ik in-HAIR-it-ens]	Transmission of gene expression patterns.\
episodic-like memory	[ep-ih-SOH-dik-like MEM-o-ree]	Nonhuman ability resembling episodic recall.\
evolutionary affordances	[eh-voh-LOO-shun-air-ee uh-FORD-ens-ez]	Opportunities shaped by evolved traits.\
evolutionary constraint	[eh-voh-LOO-shun-air-ee kon-STRAYNT]	Limits on evolutionary change.\
evolutionary mismatch	[eh-voh-LOO-shun-air-ee MISS-match]	Trait adapted to past but misaligned with current environment.\
evolutionary plasticity	[eh-voh-LOO-shun-air-ee PLAS-tiss-ih-tee]	Ability of a lineage to change adaptively.\
facial mimicry	[FAY-shul MIM-ik-ree]	Automatic copying of facial expressions.\
facial reactivity	[FAY-shul ree-AK-tiv-it-ee]	Intensity of emotional muscle movements.\
fear appraisal	[FEER ah-PRAY-zul]	Evaluation of danger.\
fear bracketing	[FEER BRAK-et-ing]	Segmenting threat into manageable pieces.\
fear extinction	[FEER ex-TINK-shun]	Reduction of conditioned fear response.\
fear extinction gradient	[FEER ex-TINK-shun GRAY-dee-ent]	Rate of decreasing fear.\
fear generalization	[FEER jen-er-ul-eye-ZAY-shun]	Fear spreading to similar cues.\
fear potentiation	[FEER poh-ten-shee-AY-shun]	Increased fear due to contextual cues.\
fight\'96flight response	[FITE FLITE ree-SPONSS]	Acute reaction to threat.\
fitness landscape	[FIT-ness LAND-skayp]	Space of possible trait combinations and fitness.\
fixed action pattern	[FIKSD AK-shun PAT-ern]	Hard-wired behavioral sequence.\
flow state	[FLOH STATE]	Absorbed, highly focused state of performance.\
food\'96safety conflict	[FOOD SAYF-tee KON-flikt]	Competition between hunger and threat.\
foraging efficiency	[FOR-uh-jing ef-FISH-en-see]	Effectiveness of food acquisition.\
freezing response	[FREEZ-ing ree-SPONSS]	Immobility triggered by threat.\
freeze\'96evaluate strategy	[FREEZ ee-VAL-yoo-ayt STRA-tuh-jee]	Freezing to assess danger.\
frustration tolerance	[frus-TRAY-shun TALL-er-ens]	Capacity to handle obstacles without dysregulation.\
gait coordination	[GAYT kor-din-AY-shun]	Harmonized movement cycles.\
gait variability	[GAYT vair-ee-uh-BILL-it-ee]	Variation in stride or rhythm.\
GABA	[GAB-uh]	Primary inhibitory neurotransmitter in CNS.\
gene\'96behavior covariance	[JEEN beh-HAY-vyer koh-VAYR-ee-ens]	Genetic link with behavioral traits.\
gestural solicitation	[JES-chur-al so-liss-ih-TAY-shun]	Requesting interaction via body movements.\
glutamate	[GLOO-tuh-mate]	Primary excitatory neurotransmitter.\
gut\'96brain threat circuit	[GUT BRAYN THRET SIR-kit]	Visceral pathways contributing to danger detection.\
guilty-look behavior	[GILL-tee LOOK beh-HAY-vyer]	Appeasement display in dogs in response to scolding.\
habituation gradient	[hah-BICH-oo-AY-shun GRAY-dee-ent]	Pattern of decreasing response with repetition.\
habituation resistance	[hah-BICH-oo-AY-shun ree-ZISS-tens]	Failure to reduce response after repetition.\
habitat complexity	[HAB-ih-tat kom-PLEKS-it-ee]	Environmental structural diversity.\
harm avoidance strategy	[HARM ah-VOY-dens STRA-tuh-jee]	Behavioral plan minimizing threat exposure.\
hazard tracking	[HAZ-ard TRAK-ing]	Monitoring for environmental dangers.\
helping behavior	[HELP-ing beh-HAY-vyer]	Prosocial assistance to others.\
herding predisposition	[HERD-ing pree-dis-puh-ZIH-shun]	Genetic tendency in some dog lineages.\
heuristic sampling	[hyoo-RISS-tik SAM-pl-ing]	Using simplified rules to process information.\
hippocampus	[HIP-oh-CAM-pus]	Brain structure vital for memory consolidation and navigation.\
homeostasis	[HOH-mee-oh-STAY-sis]	Maintaining stable internal conditions.\
hormonal fitness	[HOR-moh-nal FIT-ness]	Reproductive benefit associated with hormone levels.\
HPA axis	[H-P-A ACK-sis]	Stress-regulation pathway involving hypothalamus, pituitary, adrenal glands.\
hypersociality	[HY-per-SOH-shul-AL-it-ee]	Elevated tendency toward social engagement.\
hypervigilance	[HY-per-VIH-jih-lens]	Heightened monitoring for threat.\
hypothalamus	[hy-po-THAL-uh-muss]	Regulator of hunger, temperature, hormonal release.\
imitation fidelity	[im-ih-TAY-shun fih-DEL-it-ee]	Accuracy when copying another\'92s actions.\
imprinting window	[IM-print-ing WIN-doh]	Sensitive period for forming early attachments.\
incentive salience	[in-SEN-tiv SAY-lee-ens]	Motivational \'93wanting\'94 attributed to cues.\
incongruent signaling	[in-KON-groo-ent SIG-nuh-ling]	Mixed or conflicting behavioral cues.\
indirect reciprocity	[in-DY-rect reh-sih-PROCK-ih-tee]	Cooperation based on reputation.\
inhibitory control	[in-HIB-ih-tor-ee kon-TROHL]	Suppression of impulses or dominant responses.\
innate releasing mechanism	[ih-NATE ree-LEES-ing MEK-uh-niz-um]	Neural trigger for instinctive behaviors.\
insecure ambivalent strategy	[in-seh-KYUR am-BIV-uh-lent STRA-tuh-jee]	High-distress, inconsistent attachment pattern.\
insecure avoidant strategy	[in-seh-KYUR ah-VOY-dent STRA-tuh-jee]	Suppression of attachment cues and contact seeking.\
integrated relational organization	[in-TEG-ray-ted reh-LAY-shun-al OR-gan-eye-ZAY-shun]	Stable, well-regulated relational architecture.\
interactive buffering	[in-ter-AK-tiv BUFF-er-ing]	Reduction of stress through social interaction.\
intergenerational transmission	[in-ter-JEN-er-AY-shun-al tranz-MISS-shun]	Passing relational or behavioral patterns across generations.\
interoception	[in-ter-oh-SEP-shun]	Sensing internal bodily states.\
intrinsic motivation	[in-TRIN-zik mo-tih-VAY-shun]	Internally driven engagement in activities.\
inverted-U arousal function	[in-VER-ted YOU uh-ROW-zul FUNK-shun]	Optimal performance at moderate arousal.\
isomorphic mapping	[eye-so-MOR-fik MAP-ping]	Structural correspondence between mental states and environments.\
juvenile task repertoire	[JOO-vin-uhl TASK REP-er-twahr]	Full range of young-animal behaviors.\
juvenile tolerance window	[JOO-vin-uhl TALL-er-ens WIN-doh]	Period of increased social acceptance.\
kin competition	[KIN kom-peh-TIH-shun]	Conflict among relatives over resources.\
kin recognition	[KIN REK-ug-NIH-shun]	Ability to distinguish genetic relatives.\
kin-selected cooperation	[KIN sel-EK-ted koh-op-er-AY-shun]	Helping relatives because it increases inclusive fitness.\
latent inhibition	[LAY-tent in-HIB-ih-shun]	Difficulty forming new associations with familiar cues.\
latent threat detection	[LAY-tent THRET deh-TEK-shun]	Identifying danger early and unconsciously.\
leadership gradient	[LEE-der-ship GRAY-dee-ent]	Variation in influence within group.\
learned helplessness	[LERND HELP-less-ness]	Passivity in uncontrollable negative situations.\
learned irrelevance	[LERND ih-REL-uh-vens]	Failure to learn associations due to prior unpredictability.\
learned safety	[LERND SAYF-tee]	Conditioning that signals absence of threat.\
learning consolidation	[LERN-ing kon-sol-ih-DAY-shun]	Stabilizing memory traces after learning.\
life-history strategy	[LYFE HIS-tor-ee STRA-tuh-jee]	Developmental trajectory shaped by ecological pressures.\
liking vs. wanting distinction	[LYKE-ing versus WANT-ing]	Difference between pleasure and motivation.\
limbic disinhibition	[LIM-bick dis-in-HIB-ih-shun]	Reduced top-down emotional regulation.\
limbic system	[LIM-bick SIS-tem]	Emotion, memory, and motivation network.\
littermate effect	[LIT-er-mayt ee-FEKT]	Influence of siblings on development.\
looming-threat hypervigilance	[LOO-ming THRET HY-per-VIH-jih-lens]	Heightened sensitivity to approaching danger.\
low-uncertainty tolerance	[LOH un-SER-ten-tee TALL-er-ens]	Difficulty tolerating unpredictability.\
mate choice copying	[MAYT CHOICE KOP-ee-ing]	Copying the mate choices of others.\
maternal odor imprinting	[mah-TER-nal OH-der IM-print-ing]	Early learning of maternal scent.\
memory reconsolidation	[MEM-o-ree ree-kon-sol-ih-DAY-shun]	Restabilizing memories after retrieval.\
meta-learning	[MET-ah LERN-ing]	Learning how to learn.\
metacognition	[MET-ah-kog-NIH-shun]	Awareness of one\'92s own mental processes.\
micro-attachment cluster	[MY-kroh ah-TACH-ment KLUS-ter]	Cluster of relational signals.\
mixed-signal conflict	[MIXD SIG-nul KON-flikt]	Conflicting social cues producing stress.\
modal action pattern	[MOH-dal AK-shun PAT-ern]	Species-typical behavioral sequence.\
mode switching	[MOHD SWITCH-ing]	Rapid shift between behavioral states.\
motor persistence	[MOH-ter per-SIS-tens]	Continuing an action despite obstacles.\
multimodal integration	[MUL-tee-MOH-dal in-teg-RAY-shun]	Combining cues across senses.\
multimodal threat cue	[MUL-tee-MOH-dal THRET KYOO]	Danger signaled through multiple channels.\
mutual grooming	[MYOO-choo-ul GROO-ming]	Cooperative cleaning behavior strengthening bonds.\
narrow-sense heritability	[NAR-oh SENS HAIR-ih-tah-bill-ih-tee]	Proportion of trait variance due to additive genetics.\
neonatal freezing reflex	[NEE-oh-NAY-tal FREEZ-ing ree-FLEKS]	Early immobility response triggered by danger.\
neophobia	[nee-oh-FOH-bee-ah]	Fear of novelty.\
neophilia	[nee-oh-FILL-ee-ah]	Attraction to novelty.\
neural oscillation	[NYOO-rul oss-ih-LAY-shun]	Rhythmic brain activity.\
neural plasticity	[NYOO-rul PLAS-tiss-ih-tee]	Brain\'92s capacity to form or reorganize connections.\
neurobehavioral coherence	[NYOO-roh-beh-HAY-vyer-uhl koh-HEER-ens]	Alignment of brain and behavior responses.\
neuroplasticity	[nur-oh-plass-TISS-ih-tee]	Brain\'92s ability to adapt structurally and functionally.\
niche construction	[NEECH kon-STRUK-shun]	Organisms modifying their own environment.\
nonlinear fear recovery	[non-LIN-ee-ur FEER reh-KUV-er-ee]	Irregular decline in fear responses.\
object-choice task	[OB-jekt CHOYSS TASK]	Dog cognition task using human cues.\
observational conditioning	[ob-ZER-vay-shun-al kun-DISH-un-ing]	Learning fear or safety by watching others.\
olfactory signature	[ol-FAK-tor-ee SIG-nuh-chur]	Unique scent profile of an individual.\
opportunity structure	[op-er-TOO-nih-tee STRUK-chur]	Environmental possibilities for action.\
optimal foraging theory	[OP-tih-mul FOR-uh-jing THEE-ree]	Strategy balancing energy gained vs. effort spent.\
owner\'96dog attachment loop	[OH-ner DOG ah-TACH-ment LOOP]	Mutual regulation cycle in dog\'96human dyads.\
pack-style coordination	[PACK STYLE kor-din-AY-shun]	Synchronized movement within dog groups.\
pair bonding	[PAIR BOND-ing]	Stable, long-term affiliative relationship.\
pair separation distress	[PAIR sep-er-AY-shun dis-TRESS]	Distress triggered by absence of partner.\
parental buffering	[pah-REN-tul BUFF-er-ing]	Stress reduction via caregiver presence.\
parental buffering index	[pah-REN-tul BUFF-er-ing IN-deks]	Measure of caregiver-driven regulation.\
participatory sensemaking	[par-TISS-ih-pah-tor-ee SENS-mayk-ing]	Joint creation of meaning in interaction.\
pattern completion	[PAT-ern kom-PLEET-shun]	Filling in missing information.\
peer attachment	[PEER ah-TACH-ment]	Support-based relationship with peers.\
perceived relational instability	[per-SEEVED reh-LAY-shun-al in-stuh-BILL-ih-tee]	Sense that bonds are fragile.\
perceptual narrowing	[per-SEP-choo-ul NAR-oh-ing]	Decline in sensitivity to unused stimuli.\
pheromonal distress cue	[FAIR-oh-MOHN-al dis-TRESS KYOO]	Chemical signal indicating emotional arousal.\
play bow solicitation	[PLAY BOW so-liss-ih-TAY-shun]	Classic canine invitation to play.\
play-circuit activation	[PLAY SIR-kit ak-tih-VAY-shun]	Neural activation supporting playful behavior.\
pluralistic vigilance	[PLOO-ris-tik VIH-jih-lens]	Group members share scanning for danger.\
polygenic trait	[PAHL-ee-JEN-ik TRAYT]	Trait influenced by many genes.\
positional dominance	[poh-ZIH-shun-al DOM-in-ens]	Rank expressed through spatial control.\
positive reinforcement	[PAH-zih-tiv re-in-FORSS-ment]	Reward that increases future behavior.\
post-conflict reconciliation	[POST KON-flikt REK-on-sil-ee-AY-shun]	Affiliative behavior after aggressive events.\
prediction error	[preh-DIK-shun ERR-or]	Gap between expectation and outcome.\
preference gradient	[PREF-er-ens GRAY-dee-ent]	Distribution of choice strength across options.\
prefrontal cortex	[pre-FRONT-ul CORE-tecks]	Region for planning, inhibition, and decision-making.\
prey drive	[PRAY DRYV]	Motivation to pursue moving stimuli.\
problem-solving repertoire	[PROB-lem SOLV-ing REP-er-twahr]	Range of strategies used to solve tasks.\
prosocial behavior	[pro-SOH-shul beh-HAY-vyer]	Behavior that benefits others.\
proximal mechanisms	[PROX-ih-mul MEK-uh-niz-umz]	Immediate causes of behavior.\
punishment sensitivity	[PUN-ish-ment sen-sih-TIV-it-ee]	Degree to which aversive outcomes shape behavior.\
quorum sensing	[KWOR-um SEN-sing]	Collective decision-making based on group thresholds.\
quotient of adaptability	[KWO-shent of ah-DAP-tuh-BILL-it-ee]	Measure of behavioral flexibility.\
radial arm navigation	[RAY-dee-ul ARM nav-ih-GAY-shun]	Spatial task assessing working memory.\
reactive aggression	[ree-AK-tiv ag-GRESH-un]	Impulsive aggression triggered by threat.\
reactivity threshold	[ree-AK-tiv-it-ee THRESH-hold]	Point at which stimulus triggers strong response.\
real-time contingency tracking	[REEL-TIME kon-TIN-jen-see TRAK-ing]	Monitoring ongoing cause-and-effect.\
reciprocal altruism	[reh-SIP-roh-kul AL-troo-iz-um]	Helping nonrelatives expecting future return.\
reconsolidation window	[ree-kon-SOL-ih-DAY-shun WIN-doh]	Period where memories can be altered after recall.\
recovery\'96depletion cycle	[reh-KUV-er-ee dee-PLEET-shun SY-kul]	Alternation between resilience and exhaustion.\
redundant cueing	[reh-DUN-dent KYOO-ing]	Multiple signals reinforcing same message.\
relational asymmetry detection	[reh-LAY-shun-al ay-SIM-et-tree deh-TEK-shun]	Recognizing imbalance across caregivers.\
relational disintegration	[reh-LAY-shun-al dis-IN-teg-RAY-shun]	Breakdown of attachment architecture.\
relational safety	[reh-LAY-shun-al SAYF-tee]	Sense of security derived from social partners.\
reliability assessment	[ree-LYE-uh-BILL-it-ee ah-SESS-ment]	Evaluating consistency of signals.\
reproductive skew	[ree-pro-DUK-tiv SKYOO]	Unequal distribution of reproductive success.\
resource guarding	[REE-sorse GAR-ding]	Defensive protection of valued items.\
resource partitioning	[REE-sorse PAR-tish-un-ing]	Dividing resource use to reduce competition.\
risk assessment behavior	[RISK ah-SESS-ment beh-HAY-vyer]	Cautious investigation in uncertain conditions.\
risk dominance	[RISK DOM-in-ens]	Strategy outperforming others in uncertain environments.\
risk\'96reward calibration	[RISK ree-WARD kal-ih-BRAY-shun]	Balancing threat and benefit.\
risk\'96safe oscillation	[RISK SAYF os-ih-LAY-shun]	Switching between exploratory and safety-seeking modes.\
role-specific affiliative cue	[ROHL spih-SIFF-ik ah-FILL-ee-ah-tiv KYOO]	Bond signal unique to relational role.\
rule abstraction	[ROOL ab-STRAK-shun]	Extracting general rules from patterns.\
salience detection	[SAY-lee-ens deh-TEK-shun]	Identifying important environmental cues.\
scarcity mindset	[SKAIR-sih-tee MYND-set]	Cognitive bias shaped by resource limitation.\
schema updating	[SKEE-mah UP-day-ting]	Revising mental representations.\
seasonal polyphenism	[SEE-zun-al pol-ee-FEE-niz-um]	Environment-driven variation in behavior or morphology.\
secondary attachment system	[SEK-un-dair-ee ah-TACH-ment SIS-tem]	Backup relational system.\
secondary reinforcement	[SEK-un-dair-ee re-in-FORSS-ment]	Reward learned through association.\
selective attention	[seh-LEK-tiv uh-TEN-shun]	Focusing on relevant stimuli.\
self-domestication	[self doh-MESS-tih-KAY-shun]	Reduced aggression within a species without human selection.\
self-handicapping	[self HAN-dee-KAP-ing]	Costly display advertising quality.\
self-regulation	[self reg-yoo-LAY-shun]	Managing emotional and motivational states.\
semantic mapping	[seh-MAN-tik MAP-ping]	Linking concepts to meanings.\
sensitivity analysis	[SEN-sih-TIV-it-ee uh-NAL-ih-sis]	Testing variable influence on outcomes.\
sensory bias hypothesis	[SEN-sor-ee BYE-uss hy-POTH-eh-sis]	Pre-existing preferences drive evolution of signals.\
sensory exploitation	[SEN-sor-ee ek-SLOY-tay-shun]	Signals evolving to trigger sensory biases.\
serial reversal learning	[SEER-ee-ul ree-VER-sal LERN-ing]	Learning flexibility when contingencies reverse.\
sexual dimorphism	[SEK-shoo-al dye-MOR-fiz-um]	Trait differences between sexes.\
sexual selection	[SEK-shoo-al sel-ECK-shun]	Mating-based evolutionary pressure.\
shadowing behavior	[SHAD-oh-ing beh-HAY-vyer]	Following others closely.\
shared intentionality	[SHARED in-TEN-shun-AL-ih-tee]	Collaborative understanding.\
signal reliability	[SIG-nul ree-LY-uh-bill-ih-tee]	Trustworthiness of communication cues.\
signal-to-noise ratio	[SIG-nul too NOYZ RAY-shoh]	Strength of signal relative to noise.\
silhouette recognition	[sill-oo-ET rek-og-NIH-shun]	Identifying shapes from outlines.\
skeletal robusticity	[SKEH-luh-tul roh-bus-TISS-ih-tee]	Strength of bone structure.\
skill transfer	[SKILL TRANZ-fer]	Applying learning to new contexts.\
sleep-dependent learning	[SLEEP deh-PEN-dent LERN-ing]	Memory consolidation during sleep.\
social buffering	[SOH-shul BUFF-er-ing]	Stress reduction via social presence.\
social competition	[SOH-shul kom-peh-TIH-shun]	Competing over resources or mates.\
social contagion	[SOH-shul kon-TAY-jun]	Spread of emotion or behavior through groups.\
social facilitation	[SOH-shul fah-sill-ih-TAY-shun]	Improved performance in presence of others.\
social grooming	[SOH-shul GROO-ming]	Affiliative touch maintaining bonds.\
social heuristics	[SOH-shul hyoo-RIS-tiks]	Quick relational decision rules.\
social inhibition	[SOH-shul in-HIB-ih-shun]	Holding back behavior in group settings.\
social intelligence hypothesis	[SOH-shul in-TELL-ih-jens hy-POTH-eh-sis]	Group living drove cognitive evolution.\
social learning strategy	[SOH-shul LERN-ing STRA-tuh-jee]	Rules for when to copy others.\
social niche construction	[SOH-shul NEECH kon-STRUK-shun]	Individuals shaping their social environment.\
social preference gradient	[SOH-shul PREF-er-ens GRAY-dee-ent]	Ranking of social partners.\
social referencing	[SOH-shul REF-er-en-sing]	Using others\'92 cues for guidance.\
social reinforcement	[SOH-shul re-in-FORSS-ment]	Reward from social interactions.\
social regulation	[SOH-shul reg-yoo-LAY-shun]	Processes maintaining group stability.\
social retaliation	[SOH-shul reh-TAL-ee-AY-shun]	Acting in response to social injury.\
social tolerance	[SOH-shul TALL-er-ens]	Allowing others close without aggression.\
social transmission	[SOH-shul tranz-MISS-shun]	Passing behavior between individuals.\
socioecological model	[soh-see-oh-ee-KOL-oh-jee-kul MAH-dul]	Behavioral structure shaped by ecology.\
socioemotional repair	[soh-see-oh-ee-MOH-shun-al ree-PAIR]	Restoring emotional connection.\
sociolinguistic signaling	[soh-see-oh-ling-GWISS-tik SIG-nuh-ling]	Language-based social cues.\
sociometric status	[soh-see-oh-MEH-trik STAY-tus]	Standing in group hierarchy.\
sociotechnical niche	[soh-see-oh-TEK-ni-kul NEECH]	Human-created environmental niche.\
soft selection	[SOFT sel-ECK-shun]	Fitness differences not tied to survival.\
spatial cognition	[SPAY-shul kog-NIH-shun]	Processing spatial information.\
spatial discounting	[SPAY-shul DIS-kount-ing]	Lower valuation of distant rewards.\
spatial fidelity	[SPAY-shul fih-DEL-it-ee]	Consistent return to same area.\
spatial memory	[SPAY-shul MEM-o-ree]	Remembering locations.\
species-typical behavior	[SPEE-sheez TIPP-ih-kul]	Characteristic behavior of a species.\
speed\'96accuracy trade-off	[SPEED AK-yur-ah-see TRADE-off]	Balancing precision and speed.\
stereotypic behavior	[stair-ee-oh-TIPP-ik]	Repetitive, stress-related behavior.\
stress inoculation	[STRESS ih-NOK-yoo-LAY-shun]	Training resilience through manageable stress.\
stress reactivity	[STRESS ree-AK-tiv-it-ee]	Strength of stress response.\
string-pulling problem solving	[STRING PULL-ing PROB-lem SOLV-ing]	Causal reasoning task.\
structural power	[STRUK-chur-al POW-er]	Influence derived from social role.\
submissive signal	[sub-MISS-iv SIG-nul]	Gesture expressing non-threat.\
supernormal stimulus	[SOO-per-NOR-mal STIM-yoo-lus]	Exaggerated cue triggering strong response.\
survival processing	[sir-VY-vul pross-ess-ing]	Enhanced memory for survival-related content.\
synergistic selection	[SIN-er-JISS-tik sel-ECK-shun]	Combined selective pressures amplifying effects.\
syntactic sequencing	[sin-TAK-tik SEE-kwen-sing]	Ordered combination of signals.\
tail-chasing behavior	[TAYL CHAY-sing]	Circular spinning common in dogs.\
task allocation	[TASK al-oh-KAY-shun]	Role distribution in groups.\
temporal discounting	[TEM-por-al DIS-kount-ing]	Preference for immediate rewards.\
temporal integration	[TEM-por-al in-teg-RAY-shun]	Combining information over time.\
territorial marking	[ter-ih-TOR-ee-uhl MARK-ing]	Scent or visual boundary signals.\
territorial conflict suppression	[ter-ih-TOR-ee-uhl KON-flikt suh-PRESH-un]	Reducing aggression over territory.\
thalamus	[THAL-uh-muss]	Brain\'92s sensory relay hub.\
threat appraisal	[THRET ah-PRAY-zul]	Evaluation of danger level.\
threat generalization	[THRET jen-er-ul-eye-ZAY-shun]	Fear spreading beyond original cue.\
threat sensitivity	[THRET sen-sih-TIV-it-ee]	Responsiveness to potential harm.\
threat\'96attachment interference	[THRET ah-TACH-ment in-ter-FEER-ens]	Danger cues disrupting relational systems.\
threat\'96food competition	[THRET FOOD kom-peh-TIH-shun]	Conflict between survival systems.\
threshold effect	[THRESH-hold uh-FEKT]	Point where small changes create big shifts.\
tool-assisted foraging	[TOOL ah-SIS-ted FOR-uh-jing]	Use of objects to acquire food.\
top-down modulation	[TOP-down mod-yoo-LAY-shun]	Cognitive control over sensory processing.\
trait covariance	[TRAYT koh-VAYR-ee-ens]	Correlation among traits.\
trait heritability	[TRAYT HAIR-ih-tah-bill-ih-tee]	Genetic contribution to variation.\
trait plasticity	[TRAYT PLAS-tiss-ih-tee]	Flexibility of trait expression.\
transgenerational epigenetics	[tranz-JEN-er-AY-shun-ul ep-ih-jeh-NET-iks]	Epigenetic inheritance across generations.\
transient alliances	[TRANZ-ee-ent uh-LY-ens-ez]	Temporary social partnerships.\
triadic interactions	[try-ADD-ik in-ter-AK-shunz]	Interactions among three individuals.\
two-action task	[TOO AK-shun TASK]	Social learning task using two distinct demonstrations.\
ultrasonic vocalization	[ull-trah-SON-ik voh-kal-ih-ZAY-shun]	High-frequency calls used in many mammals.\
umwelt	[OOM-velt]	Species-specific perceptual world.\
unconditioned response	[un-kon-DISH-und ree-SPONSS]	Innate reaction to a stimulus.\
unexpected uncertainty	[un-ek-SPECK-ted un-SER-ten-tee]	Change in contingencies requiring rapid adjustment.\
upper-bound fitness	[UP-er BOWND FIT-ness]	Maximum potential reproductive success.\
utility maximization	[yoo-TILL-ih-tee maks-ih-MY-zay-shun]	Choosing actions maximizing expected outcomes.\
vagus nerve regulation	[VAY-gus NERV reg-yoo-LAY-shun]	Autonomic control supporting calm and safety.\
value updating	[VAL-yoo UP-day-ting]	Revising expectations based on new information.\
variable interval schedule	[VARE-ee-uh-bul IN-ter-vul SKEJ-ool]	Reinforcement at unpredictable time intervals.\
variable ratio schedule	[VARE-ee-uh-bul RAY-shee-oh SKEJ-ool]	Reinforcement after unpredictable number of responses.\
ventral pallidum	[VEN-trul PAL-ih-dum]	Basal ganglia region involved in reward and motivation.\
ventral striatum	[VEN-trul stry-AY-tum]	Key reward-processing region.\
ventral tegmental area	[VEN-trull teg-MEN-tul AIR-ee-uh]	Dopaminergic reward center.\
vigilance gradient	[VIH-jih-lens GRAY-dee-ent]	Range of scanning intensity for threat detection.\
visual cliff paradigm	[VIZH-oo-ul CLIFF para-dime]	Classic test of depth perception.\
visual-sniff integration	[VIZH-oo-ul SNIFF in-teg-RAY-shun]	Combining sight and olfactory cues.\
vocal mimicry	[VOH-kul MIM-ik-ree]	Copying vocalizations of others.\
vocal repertoire	[VOH-kul REP-er-twahr]	Range of communicative sounds.\
volatile cues	[VOL-ah-til KYOOZ]	Chemical signals dispersed through air.\
waggle dance communication	[WAG-ul DANS kom-yoo-nih-KAY-shun]	Honeybee spatial communication signal.\
warm-glow cooperation	[WARM GLOH koh-op-er-AY-shun]	Helping reinforced by internal reward.\
watchful waiting strategy	[WATCH-ful WAYT-ing STRA-tuh-jee]	Monitoring threat without immediate action.\
weighing trade-offs	[WAI-ing TRADE-offz]	Balancing competing priorities.\
win\'96stay lose\'96shift strategy	[WIN STAY LOOZ SHIFT]	Reinforcement-based learning strategy.\
withdrawal\'96approach conflict	[WITH-draw-uhl ah-PROACH KON-flikt]	Tension between avoidance and exploration.\
working alliance consolidation	[WERK-ing ah-LYE-ens kon-sol-ih-DAY-shun]	Stabilizing cooperative interactions.\
working memory load	[WERK-ing MEM-o-ree LOHD]	Cognitive burden on short-term storage.\
xenophilia	[zen-oh-FILL-ee-ah]	Attraction to novelty or unfamiliar individuals.\
xenophobia	[zen-oh-FOH-bee-ah]	Fear of outsiders or novelty.\
yawn-communication loop	[YAWN kom-yoo-nih-KAY-shun LOOP]	Feedback cycle of contagious yawning.\
yawning contagion	[YAWN-ing kon-TAY-jun]	Spread of yawns via social cues.\
zooarchaeology	[zoo-ar-kee-OL-oh-jee]	Study of animal remains from archaeological sites.\
zoonotic spillover	[zoo-NOT-ick SPILL-oh-ver]	Disease transmission from animals to humans.\
zoopharmacognosy	[zoo-far-mah-KOG-noh-see]	Animal use of natural substances for self-medication.\
zoosemiotics	[zoo-see-mee-OT-iks]	Study of animal communication/sign systems.\
zygote selection	[ZYE-goht sel-ECK-shun]	Fitness differences acting before or at fertilization.\
zealous resource guarding	[ZELL-us REE-sorse GAR-ding]	Intense defensive protection of valued items.\
zone of safety	[ZOHN of SAYF-tee]	Subjective spatial buffer that reduces perceived threat.}