{\rtf1\ansi\ansicpg1252\cocoartf2822
\cocoatextscaling0\cocoaplatform0{\fonttbl\f0\fswiss\fcharset0 Helvetica;}
{\colortbl;\red255\green255\blue255;}
{\*\expandedcolortbl;;}
\margl1440\margr1440\vieww11520\viewh8400\viewkind0
\pard\tx720\tx1440\tx2160\tx2880\tx3600\tx4320\tx5040\tx5760\tx6480\tx7200\tx7920\tx8640\pardirnatural\partightenfactor0

\f0\fs24 \cf0 aberrant_behavior	[AB-err-ant]	Behavior deviating from expected species-typical patterns.\
abiotic_pressure	[ay-BYE-oh-tick]	Nonliving environmental forces shaping selection.\
absolute_fitness	[AB-so-loot FIT-ness]	Total reproductive success of an organism.\
acoustic_signaling	[ah-KOO-stik SIG-nuh-ling]	Communication via sound in animals.\
actuarial_risk	[ak-CHOO-air-ee-uhl risk]	Probability of adverse developmental or behavioral outcomes.\
adaptive_advantage	[ah-DAP-tiv ad-VAN-tij]	Trait\'92s contribution to survival or reproduction.\
adaptive_calibration	[ah-DAP-tiv kal-ih-BRAY-shun]	Tuning of behavior to environmental conditions.\
adaptive_flexibility	[ah-DAP-tiv FLEK-sih-bill-ih-tee]	Ability to adjust behaviors in shifting contexts.\
adaptive_latency	[ah-DAP-tiv LAY-ten-see]	Delay in response that increases fitness under certain pressures.\
adaptive_plasticity	[ah-DAP-tiv PLAS-tiss-ih-tee]	Capacity to adjust behavior or physiology in response to experience.\
adversarial_threat	[ad-ver-SAIR-ee-uhl THRET]	Environmental or social source of danger.\
affective_valence	[ah-FEK-tiv VAY-lence]	Emotional positivity or negativity associated with stimuli.\
affiliative_grimace	[ah-FILL-ee-ah-tiv GRIM-iss]	Submissive facial expression used to reduce conflict.\
agonistic_behavior	[ag-oh-NISS-tik]	Conflict-related behavior such as threat or submission.\
alarm_calling	[ah-LARM CALL-ing]	Warning signal given to conspecifics.\
allogrooming	[AL-oh-GROO-ming]	Grooming another individual for social bonding.\
allomothering	[AL-oh-MUH-ther-ing]	Care of young by non-mothers.\
altricial_species	[al-TRISH-uhl]	Species born helpless requiring extensive parental care.\
altruistic_behavior	[al-TROO-iss-tik]	Cooperative acts benefiting others at personal cost.\
amygdala	[uh-MIG-duh-luh]	Limbic structure central to fear, threat detection, and emotion.\
amygdala_reactivity	[uh-MIG-duh-luh ree-AK-tiv-it-ee]	Sensitivity of amygdala to threat cues.\
ancestral_environment	[an-SESS-tral en-VYE-run-ment]	Evolutionary conditions that shaped adaptation.\
ancestral_fear_module	[an-SESS-tral FEER MOD-yool]	Rapid, evolved system for detecting danger.\
androgen_exposure	[AN-droh-jen ex-POH-zher]	Hormonal influence shaping development and behavior.\
animal_personality	[AN-ih-muhl per-suh-NAL-ih-tee]	Stable behavioral differences across individuals.\
anticipatory_stress_response	[an-TISS-ih-pay-tor-ee STRESS ree-SPONSS]	Preparing physiologically for predicted threat.\
anticipatory_vigilance	[an-TISS-ih-pay-tor-ee VIH-jih-lens]	Monitoring for potential threats before they occur.\
anterior_cingulate_cortex	[an-TEER-ee-or SING-gyoo-lit CORE-tecks]	Region involved in conflict detection and affect regulation.\
attachment_asymmetry	[ah-TACH-ment ay-SIM-et-tree]	Uneven relational security across caregivers.\
attachment_distress	[ah-TACH-ment dis-TRESS]	Arousal triggered by separation or relational conflict.\
attachment_plasticity	[ah-TACH-ment PLAS-tiss-ih-tee]	Flexibility of attachment responses over time.\
attachment_proximity_seeking	[ah-TACH-ment PROCK-sim-it-ee SEEK-ing]	Behavior aimed at maintaining closeness to attachment figures.\
attachment_strategies	[ah-TACH-ment STRA-tuh-jeez]	Adaptive patterns regulating closeness and security.\
auditory_cognition	[AW-dih-tor-ee kog-NIH-shun]	Processing and interpretation of sound information.\
aversive_conditioning	[ah-VER-siv kun-DISH-un-ing]	Learning via negative or unpleasant stimuli.\
avoidance_hierarchy	[ah-VOY-dens HI-er-ark-ee]	Ordered sequence of avoidance responses.\
barking_repertoires	[BAR-king REP-er-twahrz]	Full range of bark types used by dogs.\
basal_ganglia	[BAY-zul GANG-lee-uh]	Subcortical nuclei involved in reward, learning, and movement.\
baseline_threat_sensitivity	[BASE-line THRET sen-sih-TIV-ih-tee]	Default vigilance to danger cues.\
behavioral_asymmetry	[bee-HAY-vyer-uhl ay-SIM-et-tree]	Imbalanced behavioral responses across contexts.\
behavioral_contagion	[bee-HAY-vyer-uhl kon-TAY-jun]	Spread of behavior across individuals.\
behavioral_decoupling	[bee-HAY-vyer-uhl dee-KUP-ling]	Acting independently from emotional arousal.\
behavioral_ecology	[bee-HAY-vyer-uhl ee-KOL-oh-jee]	Evolutionary analysis of behavior in ecological context.\
behavioral_entrainment	[bee-HAY-vyer-uhl en-TRAIN-ment]	Synchronizing behavior to external rhythms.\
behavioral_flexibility	[bee-HAY-vyer-uhl FLEK-sih-bill-ih-tee]	Ability to modify actions based on context.\
behavioral_immunization	[bee-HAY-vyer-uhl ih-MYOO-nih-ZAY-shun]	Resilience gained via manageable stress exposure.\
behavioral_inhibition	[bee-HAY-vyer-uhl in-HIB-ih-shun]	Tendency to withdraw from novelty or threat.\
behavioral_latency	[bee-HAY-vyer-uhl LAY-ten-see]	Time delay before behavioral response.\
behavioral_lateralization	[bee-HAY-vyer-uhl lat-er-uh-LY-zay-shun]	Asymmetries in behavior linked to brain hemisphere specialization.\
behavioral_modulation	[bee-HAY-vyer-uhl mod-yoo-LAY-shun]	Adjustment of behavior to internal or external cues.\
behavioral_phenotype	[bee-HAY-vyer-uhl FEE-noh-type]	Behavioral expression shaped by genetic and environmental factors.\
behavioral_renormalization	[bee-HAY-vyer-uhl ree-NOR-mal-eye-ZAY-shun]	Returning behavior to adaptive levels.\
behavioral_synchrony	[bee-HAY-vyer-uhl SING-kruh-nee]	Coordinated timing of actions between individuals.\
behavioral_thermoregulation	[bee-HAY-vyer-uhl ther-moh-REG-yoo-lay-shun]	Behavior used to regulate temperature.\
behavioral_trade_off	[bee-HAY-vyer-uhl TRADE-off]	Balancing competing behavioral demands.\
benefit_cost_ratio	[BEN-eh-fit COST ray-shee-oh]	Fitness balance of benefits minus costs.\
belyaev_domestication_hypothesis	[bel-YAH-ev doh-MESS-tih-KAY-shun hy-POTH-eh-sis]	Tameness selection drives morphological and behavioral change.\
biobehavioral_threat_system	[bye-oh-beh-HAY-vyer-uhl THRET SIS-tem]	Integrated neural + hormonal defense network.\
bioenergetic_load	[bye-oh-en-er-JET-ik LOHD]	Metabolic cost of a trait or behavior.\
biological_preparedness	[bye-oh-LOJ-ick-uhl pre-PAIR-ed-ness]	Evolutionary readiness to learn certain associations.\
biotic_resource	[bye-AH-tick REE-sorse]	Living component of an ecosystem.\
bond_degradation	[BOND deg-ruh-DAY-shun]	Erosion of relational security.\
bonding_circuitry	[BOND-ing SIR-kuht-ree]	Neural systems involved in attachment.\
bottom_up_processing	[BOT-um UP pross-ess-ing]	Sensory-driven information flow.\
breed_specific_behavior	[BREED-spih-SIFF-ik]	Characteristic tendencies of a lineage or breed.\
brood_parasitism	[BROOD PAIR-uh-sit-iz-um]	Reproductive strategy outsourcing parental care.\
buffering_mechanism	[BUFF-er-ing MEH-kuh-niz-um]	Process preventing negative effects.\
canid_cognition	[KAY-nid kog-NIH-shun]	Mental processes in dogs, wolves, foxes.\
canid_neoteny	[KAY-nid nee-OT-en-ee]	Retention of juvenile traits into adulthood.\
canine_attachment	[KAY-nine ah-TACH-ment]	Dog\'96human bonding system.\
canine_attachment_asymmetry	[KAY-nine ah-TACH-ment ay-SIM-et-tree]	Uneven attachment across caregivers.\
canine_attentional_bias	[KAY-nine uh-TEN-shun-al BYE-uss]	Preferential attention to certain cues.\
canine_cooperative_communication	[KAY-nine koh-OP-er-uh-tiv kom-yoo-nih-KAY-shun]	Dog\'96human joint-action signaling.\
canine_displacement_behavior	[KAY-nine DIS-place-ment beh-HAY-vyer]	Stress behaviors such as yawning or shaking.\
canine_dominance_ambiguity	[KAY-nine DOM-ih-nens am-BIG-yoo-ih-tee]	Context-dependent rank relationships.\
canine_gaze_alternation	[KAY-nine GAYZ alt-er-NAY-shun]	Switching gaze between human and object to request assistance.\
canine_helping_behavior	[KAY-nine HELP-ing]	Prosocial actions directed at social partners.\
canine_hyperfocus	[KAY-nine HY-per-FOH-kuss]	Intensified attention toward a stimulus.\
canine_hypersociability	[KAY-nine HY-per-SOH-shuh-BILL-ih-tee]	Elevated affiliative behavior typical in domesticated dogs.\
canine_prosociality	[KAY-nine pro-SOH-shal-it-ee]	Positive social behavior toward dogs or humans.\
canine_reactivity	[KAY-nine ree-AK-tiv-it-ee]	Intensity of dog\'92s emotional responses.\
canine_social_referencing	[KAY-nine SOH-shul REF-er-en-sing]	Using human emotional cues for decision-making.\
canine_threat_calibration	[KAY-nine THRET kal-ih-BRAY-shun]	Adjusting vigilance to context.\
caregiver_specific_valence	[CARE-giv-er spih-SIFF-ik VAY-lence]	Emotion tied to specific attachment figures.\
cerebellum	[sair-uh-BELL-um]	Structure coordinating balance, motor learning, and movement precision.\
cerebral_cortex	[suh-REE-brull CORE-tecks]	Brain\'92s outer layer for cognition and planning.\
chemical_communication	[KEM-ih-kul kom-yoo-nih-KAY-shun]	Signaling via scent molecules.\
clan_level_cohesion	[CLAN-level koh-HEE-zhun]	Strength of bonds within multi-dog or multi-human groups.\
classical_conditioning	[KLASS-ih-kul kun-DISH-un-ing]	Learning associations between neutral and meaningful stimuli.\
climate_related_selection	[KLY-mit ree-LAY-ted sel-ECK-shun]	Environmental pressures tied to weather patterns.\
cognitive_bias	[KOG-nih-tiv BYE-uss]	Systematic pattern of thinking that affects decisions.\
cognitive_dissonance	[KOG-nih-tiv DISS-oh-nens]	Conflict between beliefs or expectations.\
cognitive_ecology	[KOG-nih-tiv ee-KOL-oh-jee]	Study of cognitive traits shaped by environment.\
cognitive_flexibility	[KOG-nih-tiv FLEK-sih-bill-ih-tee]	Ability to switch strategies or perspectives.\
cognitive_inhibition	[KOG-nih-tiv in-HIB-ih-shun]	Suppressing irrelevant information.\
cognitive_load	[KOG-nih-tiv LOHD]	Mental effort required by a task.\
cognitive_mapping	[KOG-nih-tiv MAP-ing]	Internal representation of spatial layout.\
cognitive_niche	[KOG-nih-tiv NEECH]	Environment constructed through cognitive abilities.\
cognitive_offloading	[KOG-nih-tiv OFF-load-ing]	Using environment/tools to reduce mental burden.\
cognitive_specialization	[KOG-nih-tiv spesh-uhl-eye-ZAY-shun]	Evolution of domain-specific cognitive abilities.\
conflict_induced_ambivalence	[KON-flikt in-DOOST am-BIV-uh-lens]	Mixed motivational states after threat.\
conscious_awareness	[KON-shuss uh-WAIR-ness]	Ability to process information with reflection.\
conspecific_play_arc	[kon-SPESS-ih-fik PLAY ark]	Typical sequence of play behaviors.\
conspecific_recognition	[kon-SPESS-ih-fik REK-ug-NIH-shun]	Identifying members of same species.\
contextual_fear_learning	[kon-TEKS-choo-ul FEER LERN-ing]	Learning threat based on environment.\
contingent_affiliative_cue	[kun-TIN-jent ah-FILL-ee-ah-tiv KYOO]	Social signal dependent on relational context.\
counterpredatory_strategies	[COUNT-er-PREH-dah-tor-ee STRA-tuh-jeez]	Actions reducing predator advantage.\
corpus_callosum	[CORE-pus kah-LOW-sum]	Fiber tract connecting brain hemispheres.\
cortisol_reactivity	[KOR-tih-sol ree-AK-tiv-it-ee]	Hormonal response to stress.\
cue_competition	[KYOO kom-peh-TIH-shun]	Cues interfere in predicting outcomes.\
cue_salience	[KYOO SAY-lee-ens]	Noticeability or prominence of a signal.\
cultural_transmission	[KULL-chur-al tranz-MISS-shun]	Passing behavior socially across generations.\
curiosity_drive	[KYOO-ree-AH-sih-tee DRYV]	Motivation to explore and seek new information.\
cyclic_threat_pattern	[SYE-klik THRET PAT-ern]	Recurring fluctuations in danger level.\
danger_gradient_mapping	[DANE-jer GRAY-dee-ent MAP-ping]	Tracking spatial variation in threat intensity.\
decision_latency	[deh-SIH-zhun LAY-ten-see]	Delay before choosing between alternatives.\
deep_homology	[DEEP hah-MOL-oh-jee]	Shared genetic and developmental origins across species.\
defensive_aggression	[deh-FEN-siv ag-GRESH-un]	Aggression triggered by fear or threat.\
defensive_posturing	[deh-FEN-siv POS-chur-ing]	Body signals preparing for protection.\
deferred_imitation	[deh-FERD ih-MAY-shun]	Copying behavior after delay.\
deferred_punishment_sensitivity	[deh-FERD PUN-ish-ment sen-sih-TIV-it-ee]	Responsiveness to consequences that are delayed.\
delayed_reinforcement	[deh-LAYD re-in-FORSS-ment]	Reward occurring after the behavior.\
developmental_fear_pruning	[deh-VEL-op-ment-uhl FEER PROON-ing]	Reduction of early fear responses with experience.\
developmental_plasticity	[deh-VEL-op-ment-uhl PLAS-tiss-ih-tee]	Capacity for changing traits across development.\
differential_reinforcement_of_calm	[DIF-fer-EN-shul re-in-FORSS-ment of CALM]	Reinforcing low-arousal states.\
differential_susceptibility	[DIF-fer-EN-shul suh-SEP-tuh-bill-it-ee]	Sensitivity to good and bad environments.\
direct_reciprocity	[di-REKT reh-sih-PROCK-ih-tee]	Cooperation based on repeated interactions.\
disclosure_effect	[dis-KLO-zher eh-FEKT]	Increased trust after revealing information.\
displacement_activity	[dis-PLACE-ment ak-TIV-it-ee]	Behavior expressing conflict, stress, or inhibition.\
distance_rule_conflict	[DIS-tens ROOL KON-flikt]	Tension between distance and social bonding.\
distributed_cognition	[dis-TRIB-yoo-ted kog-NIH-shun]	Thinking spread across individuals and environment.\
dog_human_co_regulation	[DOG HYOO-man koh-reg-yoo-LAY-shun]	Human-supported emotional regulation in dogs.\
dominance_hierarchy	[DOM-ih-nens HI-er-ark-ee]	Ranked order of power or access among individuals.\
dopamine	[DOPE-uh-meen]	Neurotransmitter for reward, motivation, reinforcement learning.\
downregulation	[DOWN-reg-yoo-LAY-shun]	Reduction of emotional or physiological intensity.\
dual_process_theory	[DOO-ul PROS-ess THEE-ree]	Two interacting systems: fast automatic and slow controlled.\
dynamic_social_signaling	[dye-NAM-ik SOH-shul SIG-nuh-ling]	Flexible expression of communication cues.\
ecological_grief	[ee-koh-LOJ-ik-uhl GREEF]	Emotional distress from environmental degradation.\
ecological_intelligence	[ee-koh-LOJ-ik-uhl in-TELL-ih-jens]	Cognition specialized for environmental demands.\
ecological_niche	[ee-koh-LOJ-ik-uhl NEECH]	Ecological role a species occupies.\
ecological_validity	[ee-koh-LOJ-ik-uhl vah-LID-it-ee]	How well findings generalize to real world.\
eco_social_trade_off	[EE-koh SOH-shul TRADE-off]	Balancing ecology and social demands.\
effect_size	[eh-FEKT SIZE]	Magnitude of an observed relationship.\
emotion_contagion	[ee-MOH-shun kon-TAY-jun]	Spread of affect across individuals.\
emotion_action_decoupling	[ee-MOH-shun AK-shun dee-KUP-ling]	Inhibiting action despite emotional arousal.\
emotional_buffering	[ee-MOH-shun-al BUFF-er-ing]	Reducing stress through supportive presence.\
emotional_reactivity	[ee-MOH-shun-al ree-AK-tiv-it-ee]	Intensity of emotional responses.\
endogenous_attention	[en-DAH-juh-nus uh-TEN-shun]	Internally driven focus.\
environmental_affordances	[en-VYE-run-men-tal uh-FORD-ens-ez]	Opportunities for action in environment.\
epigenetic_inheritance	[ep-ih-jeh-NET-ik in-HAIR-it-ens]	Transmission of gene expression patterns.\
episodic_like_memory	[ep-ih-SOH-dik-like MEM-o-ree]	Nonhuman ability resembling episodic recall.\
evolutionary_affordances	[eh-voh-LOO-shun-air-ee uh-FORD-ens-ez]	Opportunities shaped by evolved traits.\
evolutionary_constraint	[eh-voh-LOO-shun-air-ee kon-STRAYNT]	Limits on evolutionary change.\
evolutionary_mismatch	[eh-voh-LOO-shun-air-ee MISS-match]	Trait adapted to past but misaligned with current environment.\
evolutionary_plasticity	[eh-voh-LOO-shun-air-ee PLAS-tiss-ih-tee]	Ability of a lineage to change adaptively.\
facial_mimicry	[FAY-shul MIM-ik-ree]	Automatic copying of facial expressions.\
facial_reactivity	[FAY-shul ree-AK-tiv-it-ee]	Intensity of emotional muscle movements.\
fear_appraisal	[FEER ah-PRAY-zul]	Evaluation of danger.\
fear_bracketing	[FEER BRAK-et-ing]	Segmenting threat into manageable pieces.\
fear_extinction	[FEER ex-TINK-shun]	Reduction of conditioned fear response.\
fear_extinction_gradient	[FEER ex-TINK-shun GRAY-dee-ent]	Rate of decreasing fear.\
fear_generalization	[FEER jen-er-ul-eye-ZAY-shun]	Fear spreading to similar cues.\
fear_potentiation	[FEER poh-ten-shee-AY-shun]	Increased fear due to contextual cues.\
fight_flight_response	[FITE FLITE ree-SPONSS]	Acute reaction to threat.\
fitness_landscape	[FIT-ness LAND-skayp]	Space of possible trait combinations and fitness.\
fixed_action_pattern	[FIKSD AK-shun PAT-ern]	Hard-wired behavioral sequence.\
flow_state	[FLOH STATE]	Absorbed, highly focused state of performance.\
food_safety_conflict	[FOOD SAYF-tee KON-flikt]	Competition between hunger and threat.\
foraging_efficiency	[FOR-uh-jing ef-FISH-en-see]	Effectiveness of food acquisition.\
freezing_response	[FREEZ-ing ree-SPONSS]	Immobility triggered by threat.\
freeze_evaluate_strategy	[FREEZ ee-VAL-yoo-ayt STRA-tuh-jee]	Freezing to assess danger.\
frustration_tolerance	[frus-TRAY-shun TALL-er-ens]	Capacity to handle obstacles without dysregulation.\
gait_coordination	[GAYT kor-din-AY-shun]	Harmonized movement cycles.\
gait_variability	[GAYT vair-ee-uh-BILL-it-ee]	Variation in stride or rhythm.\
gaba	[GAB-uh]	Primary inhibitory neurotransmitter in CNS.\
gene_behavior_covariance	[JEEN beh-HAY-vyer koh-VAYR-ee-ens]	Genetic link with behavioral traits.\
gestural_solicitation	[JES-chur-al so-liss-ih-TAY-shun]	Requesting interaction via body movements.\
glutamate	[GLOO-tuh-mate]	Primary excitatory neurotransmitter.\
gut_brain_threat_circuit	[GUT BRAYN THRET SIR-kit]	Visceral pathways contributing to danger detection.\
guilty_look_behavior	[GILL-tee LOOK beh-HAY-vyer]	Appeasement display in dogs in response to scolding.\
habituation_gradient	[hah-BICH-oo-AY-shun GRAY-dee-ent]	Pattern of decreasing response with repetition.\
habituation_resistance	[hah-BICH-oo-AY-shun ree-ZISS-tens]	Failure to reduce response after repetition.\
habitat_complexity	[HAB-ih-tat kom-PLEKS-it-ee]	Environmental structural diversity.\
harm_avoidance_strategy	[HARM ah-VOY-dens STRA-tuh-jee]	Behavioral plan minimizing threat exposure.\
hazard_tracking	[HAZ-ard TRAK-ing]	Monitoring for environmental dangers.\
helping_behavior	[HELP-ing beh-HAY-vyer]	Prosocial assistance to others.\
herding_predisposition	[HERD-ing pree-dis-puh-ZIH-shun]	Genetic tendency in some dog lineages.\
heuristic_sampling	[hyoo-RISS-tik SAM-pl-ing]	Using simplified rules to process information.\
hippocampus	[HIP-oh-CAM-pus]	Brain structure vital for memory consolidation and navigation.\
homeostasis	[HOH-mee-oh-STAY-sis]	Maintaining stable internal conditions.\
hormonal_fitness	[HOR-moh-nal FIT-ness]	Reproductive benefit associated with hormone levels.\
hpa_axis	[H-P-A ACK-sis]	Stress-regulation pathway involving hypothalamus, pituitary, adrenal glands.\
hypersociality	[HY-per-SOH-shul-AL-it-ee]	Elevated tendency toward social engagement.\
hypervigilance	[HY-per-VIH-jih-lens]	Heightened monitoring for threat.\
hypothalamus	[hy-po-THAL-uh-muss]	Regulator of hunger, temperature, hormonal release.\
imitation_fidelity	[im-ih-TAY-shun fih-DEL-it-ee]	Accuracy when copying another\'92s actions.\
imprinting_window	[IM-print-ing WIN-doh]	Sensitive period for forming early attachments.\
incentive_salience	[in-SEN-tiv SAY-lee-ens]	Motivational \'93wanting\'94 attributed to cues.\
incongruent_signaling	[in-KON-groo-ent SIG-nuh-ling]	Mixed or conflicting behavioral cues.\
indirect_reciprocity	[in-DY-rect reh-sih-PROCK-ih-tee]	Cooperation based on reputation.\
inhibitory_control	[in-HIB-ih-tor-ee kon-TROHL]	Suppression of impulses or dominant responses.\
innate_releasing_mechanism	[ih-NATE ree-LEES-ing MEK-uh-niz-um]	Neural trigger for instinctive behaviors.\
insecure_ambivalent_strategy	[in-seh-KYUR am-BIV-uh-lent STRA-tuh-jee]	High-distress, inconsistent attachment pattern.\
insecure_avoidant_strategy	[in-seh-KYUR ah-VOY-dent STRA-tuh-jee]	Suppression of attachment cues and contact seeking.\
integrated_relational_organization	[in-TEG-ray-ted reh-LAY-shun-al OR-gan-eye-ZAY-shun]	Stable, well-regulated relational architecture.\
interactive_buffering	[in-ter-AK-tiv BUFF-er-ing]	Reduction of stress through social interaction.\
intergenerational_transmission	[in-ter-JEN-er-AY-shun-al tranz-MISS-shun]	Passing relational or behavioral patterns across generations.\
interoception	[in-ter-oh-SEP-shun]	Sensing internal bodily states.\
intrinsic_motivation	[in-TRIN-zik mo-tih-VAY-shun]	Internally driven engagement in activities.\
inverted_u_arousal_function	[in-VER-ted YOU uh-ROW-zul FUNK-shun]	Optimal performance at moderate arousal.\
isomorphic_mapping	[eye-so-MOR-fik MAP-ping]	Structural correspondence between mental states and environments.\
juvenile_task_repertoire	[JOO-vin-uhl TASK REP-er-twahr]	Full range of young-animal behaviors.\
juvenile_tolerance_window	[JOO-vin-uhl TALL-er-ens WIN-doh]	Period of increased social acceptance.\
kin_competition	[KIN kom-peh-TIH-shun]	Conflict among relatives over resources.\
kin_recognition	[KIN REK-ug-NIH-shun]	Ability to distinguish genetic relatives.\
kin_selected_cooperation	[KIN sel-EK-ted koh-op-er-AY-shun]	Helping relatives because it increases inclusive fitness.\
latent_inhibition	[LAY-tent in-HIB-ih-shun]	Difficulty forming new associations with familiar cues.\
latent_threat_detection	[LAY-tent THRET deh-TEK-shun]	Identifying danger early and unconsciously.\
leadership_gradient	[LEE-der-ship GRAY-dee-ent]	Variation in influence within group.\
learned_helplessness	[LERND HELP-less-ness]	Passivity in uncontrollable negative situations.\
learned_irrelevance	[LERND ih-REL-uh-vens]	Failure to learn associations due to prior unpredictability.\
learned_safety	[LERND SAYF-tee]	Conditioning that signals absence of threat.\
learning_consolidation	[LERN-ing kon-sol-ih-DAY-shun]	Stabilizing memory traces after learning.\
life_history_strategy	[LYFE HIS-tor-ee STRA-tuh-jee]	Developmental trajectory shaped by ecological pressures.\
liking_vs_wanting_distinction	[LYKE-ing versus WANT-ing]	Difference between pleasure and motivation.\
limbic_disinhibition	[LIM-bick dis-in-HIB-ih-shun]	Reduced top-down emotional regulation.\
limbic_system	[LIM-bick SIS-tem]	Emotion, memory, and motivation network.\
littermate_effect	[LIT-er-mayt ee-FEKT]	Influence of siblings on development.\
looming_threat_hypervigilance	[LOO-ming THRET HY-per-VIH-jih-lens]	Heightened sensitivity to approaching danger.\
low_uncertainty_tolerance	[LOH un-SER-ten-tee TALL-er-ens]	Difficulty tolerating unpredictability.\
mate_choice_copying	[MAYT CHOICE KOP-ee-ing]	Copying the mate choices of others.\
maternal_odor_imprinting	[mah-TER-nal OH-der IM-print-ing]	Early learning of maternal scent.\
memory_reconsolidation	[MEM-o-ree ree-kon-sol-ih-DAY-shun]	Restabilizing memories after retrieval.\
meta_learning	[MET-ah LERN-ing]	Learning how to learn.\
metacognition	[MET-ah-kog-NIH-shun]	Awareness of one\'92s own mental processes.\
micro_attachment_cluster	[MY-kroh ah-TACH-ment KLUS-ter]	Cluster of relational signals.\
mixed_signal_conflict	[MIXD SIG-nul KON-flikt]	Conflicting social cues producing stress.\
modal_action_pattern	[MOH-dal AK-shun PAT-ern]	Species-typical behavioral sequence.\
mode_switching	[MOHD SWITCH-ing]	Rapid shift between behavioral states.\
motor_persistence	[MOH-ter per-SIS-tens]	Continuing an action despite obstacles.\
multimodal_integration	[MUL-tee-MOH-dal in-teg-RAY-shun]	Combining cues across senses.\
multimodal_threat_cue	[MUL-tee-MOH-dal THRET KYOO]	Danger signaled through multiple channels.\
mutual_grooming	[MYOO-choo-ul GROO-ming]	Cooperative cleaning behavior strengthening bonds.\
narrow_sense_heritability	[NAR-oh SENS HAIR-ih-tah-bill-ih-tee]	Proportion of trait variance due to additive genetics.\
neonatal_freezing_reflex	[NEE-oh-NAY-tal FREEZ-ing ree-FLEKS]	Early immobility response triggered by danger.\
neophobia	[nee-oh-FOH-bee-ah]	Fear of novelty.\
neophilia	[nee-oh-FILL-ee-ah]	Attraction to novelty.\
neural_oscillation	[NYOO-rul oss-ih-LAY-shun]	Rhythmic brain activity.\
neural_plasticity	[NYOO-rul PLAS-tiss-ih-tee]	Brain\'92s capacity to form or reorganize connections.\
neurobehavioral_coherence	[NYOO-roh-beh-HAY-vyer-uhl koh-HEER-ens]	Alignment of brain and behavior responses.\
neuroplasticity	[nur-oh-plass-TISS-ih-tee]	Brain\'92s ability to adapt structurally and functionally.\
niche_construction	[NEECH kon-STRUK-shun]	Organisms modifying their own environment.\
nonlinear_fear_recovery	[non-LIN-ee-ur FEER reh-KUV-er-ee]	Irregular decline in fear responses.\
object_choice_task	[OB-jekt CHOYSS TASK]	Dog cognition task using human cues.\
observational_conditioning	[ob-ZER-vay-shun-al kun-DISH-un-ing]	Learning fear or safety by watching others.\
olfactory_signature	[ol-FAK-tor-ee SIG-nuh-chur]	Unique scent profile of an individual.\
opportunity_structure	[op-er-TOO-nih-tee STRUK-chur]	Environmental possibilities for action.\
optimal_foraging_theory	[OP-tih-mul FOR-uh-jing THEE-ree]	Strategy balancing energy gained vs. effort spent.\
owner_dog_attachment_loop	[OH-ner DOG ah-TACH-ment LOOP]	Mutual regulation cycle in dog\'96human dyads.\
pack_style_coordination	[PACK STYLE kor-din-AY-shun]	Synchronized movement within dog groups.\
pair_bonding	[PAIR BOND-ing]	Stable, long-term affiliative relationship.\
pair_separation_distress	[PAIR sep-er-AY-shun dis-TRESS]	Distress triggered by absence of partner.\
parental_buffering	[pah-REN-tul BUFF-er-ing]	Stress reduction via caregiver presence.\
parental_buffering_index	[pah-REN-tul BUFF-er-ing IN-deks]	Measure of caregiver-driven regulation.\
participatory_sensemaking	[par-TISS-ih-pah-tor-ee SENS-mayk-ing]	Joint creation of meaning in interaction.\
pattern_completion	[PAT-ern kom-PLEET-shun]	Filling in missing information.\
peer_attachment	[PEER ah-TACH-ment]	Support-based relationship with peers.\
perceived_relational_instability	[per-SEEVED reh-LAY-shun-al in-stuh-BILL-ih-tee]	Sense that bonds are fragile.\
perceptual_narrowing	[per-SEP-choo-ul NAR-oh-ing]	Decline in sensitivity to unused stimuli.\
pheromonal_distress_cue	[FAIR-oh-MOHN-al dis-TRESS KYOO]	Chemical signal indicating emotional arousal.\
play_bow_solicitation	[PLAY BOW so-liss-ih-TAY-shun]	Classic canine invitation to play.\
play_circuit_activation	[PLAY SIR-kit ak-tih-VAY-shun]	Neural activation supporting playful behavior.\
pluralistic_vigilance	[PLOO-ris-tik VIH-jih-lens]	Group members share scanning for danger.\
polygenic_trait	[PAHL-ee-JEN-ik TRAYT]	Trait influenced by many genes.\
positional_dominance	[poh-ZIH-shun-al DOM-in-ens]	Rank expressed through spatial control.\
positive_reinforcement	[PAH-zih-tiv re-in-FORSS-ment]	Reward that increases future behavior.\
post_conflict_reconciliation	[POST KON-flikt REK-on-sil-ee-AY-shun]	Affiliative behavior after aggressive events.\
prediction_error	[preh-DIK-shun ERR-or]	Gap between expectation and outcome.\
preference_gradient	[PREF-er-ens GRAY-dee-ent]	Distribution of choice strength across options.\
prefrontal_cortex	[pre-FRONT-ul CORE-tecks]	Region for planning, inhibition, and decision-making.\
prey_drive	[PRAY DRYV]	Motivation to pursue moving stimuli.\
problem_solving_repertoire	[PROB-lem SOLV-ing REP-er-twahr]	Range of strategies used to solve tasks.\
prosocial_behavior	[pro-SOH-shul beh-HAY-vyer]	Behavior that benefits others.\
proximal_mechanisms	[PROX-ih-mul MEK-uh-niz-umz]	Immediate causes of behavior.\
punishment_sensitivity	[PUN-ish-ment sen-sih-TIV-it-ee]	Degree to which aversive outcomes shape behavior.\
quorum_sensing	[KWOR-um SEN-sing]	Collective decision-making based on group thresholds.\
quotient_of_adaptability	[KWO-shent of ah-DAP-tuh-BILL-it-ee]	Measure of behavioral flexibility.\
radial_arm_navigation	[RAY-dee-ul ARM nav-ih-GAY-shun]	Spatial task assessing working memory.\
reactive_aggression	[ree-AK-tiv ag-GRESH-un]	Impulsive aggression triggered by threat.\
reactivity_threshold	[ree-AK-tiv-it-ee THRESH-hold]	Point at which stimulus triggers strong response.\
real_time_contingency_tracking	[REEL-TIME kon-TIN-jen-see TRAK-ing]	Monitoring ongoing cause-and-effect.\
reciprocal_altruism	[reh-SIP-roh-kul AL-troo-iz-um]	Helping nonrelatives expecting future return.\
reconsolidation_window	[ree-kon-SOL-ih-DAY-shun WIN-doh]	Period where memories can be altered after recall.\
recovery_depletion_cycle	[reh-KUV-er-ee dee-PLEET-shun SY-kul]	Alternation between resilience and exhaustion.\
redundant_cueing	[reh-DUN-dent KYOO-ing]	Multiple signals reinforcing same message.\
relational_asymmetry_detection	[reh-LAY-shun-al ay-SIM-et-tree deh-TEK-shun]	Recognizing imbalance across caregivers.\
relational_disintegration	[reh-LAY-shun-al dis-IN-teg-RAY-shun]	Breakdown of attachment architecture.\
relational_safety	[reh-LAY-shun-al SAYF-tee]	Sense of security derived from social partners.\
reliability_assessment	[ree-LYE-uh-BILL-it-ee ah-SESS-ment]	Evaluating consistency of signals.\
reproductive_skew	[ree-pro-DUK-tiv SKYOO]	Unequal distribution of reproductive success.\
resource_guarding	[REE-sorse GAR-ding]	Defensive protection of valued items.\
resource_partitioning	[REE-sorse PAR-tish-un-ing]	Dividing resource use to reduce competition.\
risk_assessment_behavior	[RISK ah-SESS-ment beh-HAY-vyer]	Cautious investigation in uncertain conditions.\
risk_dominance	[RISK DOM-in-ens]	Strategy outperforming others in uncertain environments.\
risk_reward_calibration	[RISK ree-WARD kal-ih-BRAY-shun]	Balancing threat and benefit.\
risk_safe_oscillation	[RISK SAYF os-ih-LAY-shun]	Switching between exploratory and safety-seeking modes.\
role_specific_affiliative_cue	[ROHL spih-SIFF-ik ah-FILL-ee-ah-tiv KYOO]	Bond signal unique to relational role.\
rule_abstraction	[ROOL ab-STRAK-shun]	Extracting general rules from patterns.\
salience_detection	[SAY-lee-ens deh-TEK-shun]	Identifying important environmental cues.\
scarcity_mindset	[SKAIR-sih-tee MYND-set]	Cognitive bias shaped by resource limitation.\
schema_updating	[SKEE-mah UP-day-ting]	Revising mental representations.\
seasonal_polyphenism	[SEE-zun-al pol-ee-FEE-niz-um]	Environment-driven variation in behavior or morphology.\
secondary_attachment_system	[SEK-un-dair-ee ah-TACH-ment SIS-tem]	Backup relational system.\
secondary_reinforcement	[SEK-un-dair-ee re-in-FORSS-ment]	Reward learned through association.\
selective_attention	[seh-LEK-tiv uh-TEN-shun]	Focusing on relevant stimuli.\
self_domestication	[self doh-MESS-tih-KAY-shun]	Reduced aggression within a species without human selection.\
self_handicapping	[self HAN-dee-KAP-ing]	Costly display advertising quality.\
self_regulation	[self reg-yoo-LAY-shun]	Managing emotional and motivational states.\
semantic_mapping	[seh-MAN-tik MAP-ping]	Linking concepts to meanings.\
sensitivity_analysis	[SEN-sih-TIV-it-ee uh-NAL-ih-sis]	Testing variable influence on outcomes.\
sensory_bias_hypothesis	[SEN-sor-ee BYE-uss hy-POTH-eh-sis]	Pre-existing preferences drive evolution of signals.\
sensory_exploitation	[SEN-sor-ee ek-SLOY-tay-shun]	Signals evolving to trigger sensory biases.\
serial_reversal_learning	[SEER-ee-ul ree-VER-sal LERN-ing]	Learning flexibility when contingencies reverse.\
sexual_dimorphism	[SEK-shoo-al dye-MOR-fiz-um]	Trait differences between sexes.\
sexual_selection	[SEK-shoo-al sel-ECK-shun]	Mating-based evolutionary pressure.\
shadowing_behavior	[SHAD-oh-ing beh-HAY-vyer]	Following others closely.\
shared_intentionality	[SHARED in-TEN-shun-AL-ih-tee]	Collaborative understanding.\
signal_reliability	[SIG-nul ree-LY-uh-bill-ih-tee]	Trustworthiness of communication cues.\
signal_to_noise_ratio	[SIG-nul too NOYZ RAY-shoh]	Strength of signal relative to noise.\
silhouette_recognition	[sill-oo-ET rek-og-NIH-shun]	Identifying shapes from outlines.\
skeletal_robusticity	[SKEH-luh-tul roh-bus-TISS-ih-tee]	Strength of bone structure.\
skill_transfer	[SKILL TRANZ-fer]	Applying learning to new contexts.\
sleep_dependent_learning	[SLEEP deh-PEN-dent LERN-ing]	Memory consolidation during sleep.\
social_buffering	[SOH-shul BUFF-er-ing]	Stress reduction via social presence.\
social_competition	[SOH-shul kom-peh-TIH-shun]	Competing over resources or mates.\
social_contagion	[SOH-shul kon-TAY-jun]	Spread of emotion or behavior through groups.\
social_facilitation	[SOH-shul fah-sill-ih-TAY-shun]	Improved performance in presence of others.\
social_grooming	[SOH-shul GROO-ming]	Affiliative touch maintaining bonds.\
social_heuristics	[SOH-shul hyoo-RIS-tiks]	Quick relational decision rules.\
social_inhibition	[SOH-shul in-HIB-ih-shun]	Holding back behavior in group settings.\
social_intelligence_hypothesis	[SOH-shul in-TELL-ih-jens hy-POTH-eh-sis]	Group living drove cognitive evolution.\
social_learning_strategy	[SOH-shul LERN-ing STRA-tuh-jee]	Rules for when to copy others.\
social_niche_construction	[SOH-shul NEECH kon-STRUK-shun]	Individuals shaping their social environment.\
social_preference_gradient	[SOH-shul PREF-er-ens GRAY-dee-ent]	Ranking of social partners.\
social_referencing	[SOH-shul REF-er-en-sing]	Using others\'92 cues for guidance.\
social_reinforcement	[SOH-shul re-in-FORSS-ment]	Reward from social interactions.\
social_regulation	[SOH-shul reg-yoo-LAY-shun]	Processes maintaining group stability.\
social_retaliation	[SOH-shul reh-TAL-ee-AY-shun]	Acting in response to social injury.\
social_tolerance	[SOH-shul TALL-er-ens]	Allowing others close without aggression.\
social_transmission	[SOH-shul tranz-MISS-shun]	Passing behavior between individuals.\
socioecological_model	[soh-see-oh-ee-KOL-oh-jee-kul MAH-dul]	Behavioral structure shaped by ecology.\
socioemotional_repair	[soh-see-oh-ee-MOH-shun-al ree-PAIR]	Restoring emotional connection.\
sociolinguistic_signaling	[soh-see-oh-ling-GWISS-tik SIG-nuh-ling]	Language-based social cues.\
sociometric_status	[soh-see-oh-MEH-trik STAY-tus]	Standing in group hierarchy.\
sociotechnical_niche	[soh-see-oh-TEK-ni-kul NEECH]	Human-created environmental niche.\
soft_selection	[SOFT sel-ECK-shun]	Fitness differences not tied to survival.\
spatial_cognition	[SPAY-shul kog-NIH-shun]	Processing spatial information.\
spatial_discounting	[SPAY-shul DIS-kount-ing]	Lower valuation of distant rewards.\
spatial_fidelity	[SPAY-shul fih-DEL-it-ee]	Consistent return to same area.\
spatial_memory	[SPAY-shul MEM-o-ree]	Remembering locations.\
species_typical_behavior	[SPEE-sheez TIPP-ih-kul]	Characteristic behavior of a species.\
speed_accuracy_trade_off	[SPEED AK-yur-ah-see TRADE-off]	Balancing precision and speed.\
stereotypic_behavior	[stair-ee-oh-TIPP-ik]	Repetitive, stress-related behavior.\
stress_inoculation	[STRESS ih-NOK-yoo-LAY-shun]	Training resilience through manageable stress.\
stress_reactivity	[STRESS ree-AK-tiv-it-ee]	Strength of stress response.\
string_pulling_problem_solving	[STRING PULL-ing PROB-lem SOLV-ing]	Causal reasoning task.\
structural_power	[STRUK-chur-al POW-er]	Influence derived from social role.\
submissive_signal	[sub-MISS-iv SIG-nul]	Gesture expressing non-threat.\
supernormal_stimulus	[SOO-per-NOR-mal STIM-yoo-lus]	Exaggerated cue triggering strong response.\
survival_processing	[sir-VY-vul pross-ess-ing]	Enhanced memory for survival-related content.\
synergistic_selection	[SIN-er-JISS-tik sel-ECK-shun]	Combined selective pressures amplifying effects.\
syntactic_sequencing	[sin-TAK-tik SEE-kwen-sing]	Ordered combination of signals.\
tail_chasing_behavior	[TAYL CHAY-sing]	Circular spinning common in dogs.\
task_allocation	[TASK al-oh-KAY-shun]	Role distribution in groups.\
temporal_discounting	[TEM-por-al DIS-kount-ing]	Preference for immediate rewards.\
temporal_integration	[TEM-por-al in-teg-RAY-shun]	Combining information over time.\
territorial_marking	[ter-ih-TOR-ee-uhl MARK-ing]	Scent or visual boundary signals.\
territorial_conflict_suppression	[ter-ih-TOR-ee-uhl KON-flikt suh-PRESH-un]	Reducing aggression over territory.\
thalamus	[THAL-uh-muss]	Brain\'92s sensory relay hub.\
threat_appraisal	[THRET ah-PRAY-zul]	Evaluation of danger level.\
threat_generalization	[THRET jen-er-ul-eye-ZAY-shun]	Fear spreading beyond original cue.\
threat_sensitivity	[THRET sen-sih-TIV-it-ee]	Responsiveness to potential harm.\
threat_attachment_interference	[THRET ah-TACH-ment in-ter-FEER-ens]	Danger cues disrupting relational systems.\
threat_food_competition	[THRET FOOD kom-peh-TIH-shun]	Conflict between survival systems.\
threshold_effect	[THRESH-hold uh-FEKT]	Point where small changes create big shifts.\
tool_assisted_foraging	[TOOL ah-SIS-ted FOR-uh-jing]	Use of objects to acquire food.\
top_down_modulation	[TOP-down mod-yoo-LAY-shun]	Cognitive control over sensory processing.\
trait_covariance	[TRAYT koh-VAYR-ee-ens]	Correlation among traits.\
trait_heritability	[TRAYT HAIR-ih-tah-bill-ih-tee]	Genetic contribution to variation.\
trait_plasticity	[TRAYT PLAS-tiss-ih-tee]	Flexibility of trait expression.\
transgenerational_epigenetics	[tranz-JEN-er-AY-shun-ul ep-ih-jeh-NET-iks]	Epigenetic inheritance across generations.\
transient_alliances	[TRANZ-ee-ent uh-LY-ens-ez]	Temporary social partnerships.\
triadic_interactions	[try-ADD-ik in-ter-AK-shunz]	Interactions among three individuals.\
two_action_task	[TOO AK-shun TASK]	Social learning task using two distinct demonstrations.\
ultrasonic_vocalization	[ull-trah-SON-ik voh-kal-ih-ZAY-shun]	High-frequency calls used in many mammals.\
umwelt	[OOM-velt]	Species-specific perceptual world.\
unconditioned_response	[un-kon-DISH-und ree-SPONSS]	Innate reaction to a stimulus.\
unexpected_uncertainty	[un-ek-SPECK-ted un-SER-ten-tee]	Change in contingencies requiring rapid adjustment.\
upper_bound_fitness	[UP-er BOWND FIT-ness]	Maximum potential reproductive success.\
utility_maximization	[yoo-TILL-ih-tee maks-ih-MY-zay-shun]	Choosing actions maximizing expected outcomes.\
vagus_nerve_regulation	[VAY-gus NERV reg-yoo-LAY-shun]	Autonomic control supporting calm and safety.\
value_updating	[VAL-yoo UP-day-ting]	Revising expectations based on new information.\
variable_interval_schedule	[VARE-ee-uh-bul IN-ter-vul SKEJ-ool]	Reinforcement at unpredictable time intervals.\
variable_ratio_schedule	[VARE-ee-uh-bul RAY-shee-oh SKEJ-ool]	Reinforcement after unpredictable number of responses.\
ventral_pallidum	[VEN-trul PAL-ih-dum]	Basal ganglia region involved in reward and motivation.\
ventral_striatum	[VEN-trul stry-AY-tum]	Key reward-processing region.\
ventral_tegmental_area	[VEN-trull teg-MEN-tul AIR-ee-uh]	Dopaminergic reward center.\
vigilance_gradient	[VIH-jih-lens GRAY-dee-ent]	Range of scanning intensity for threat detection.\
visual_cliff_paradigm	[VIZH-oo-ul CLIFF para-dime]	Classic test of depth perception.\
visual_sniff_integration	[VIZH-oo-ul SNIFF in-teg-RAY-shun]	Combining sight and olfactory cues.\
vocal_mimicry	[VOH-kul MIM-ik-ree]	Copying vocalizations of others.\
vocal_repertoire	[VOH-kul REP-er-twahr]	Range of communicative sounds.\
volatile_cues	[VOL-ah-til KYOOZ]	Chemical signals dispersed through air.\
waggle_dance_communication	[WAG-ul DANS kom-yoo-nih-KAY-shun]	Honeybee spatial communication signal.\
warm_glow_cooperation	[WARM GLOH koh-op-er-AY-shun]	Helping reinforced by internal reward.\
watchful_waiting_strategy	[WATCH-ful WAYT-ing STRA-tuh-jee]	Monitoring threat without immediate action.\
weighing_trade_offs	[WAI-ing TRADE-offz]	Balancing competing priorities.\
win_stay_lose_shift_strategy	[WIN STAY LOOZ SHIFT]	Reinforcement-based learning strategy.\
withdrawal_approach_conflict	[WITH-draw-uhl ah-PROACH KON-flikt]	Tension between avoidance and exploration.\
working_alliance_consolidation	[WERK-ing ah-LYE-ens kon-sol-ih-DAY-shun]	Stabilizing cooperative interactions.\
working_memory_load	[WERK-ing MEM-o-ree LOHD]	Cognitive burden on short-term storage.\
xenophilia	[zen-oh-FILL-ee-ah]	Attraction to novelty or unfamiliar individuals.\
xenophobia	[zen-oh-FOH-bee-ah]	Fear of outsiders or novelty.\
yawn_communication_loop	[YAWN kom-yoo-nih-KAY-shun LOOP]	Feedback cycle of contagious yawning.\
yawning_contagion	[YAWN-ing kon-TAY-jun]	Spread of yawns via social cues.\
zooarchaeology	[zoo-ar-kee-OL-oh-jee]	Study of animal remains from archaeological sites.\
zoonotic_spillover	[zoo-NOT-ick SPILL-oh-ver]	Disease transmission from animals to humans.\
zoopharmacognosy	[zoo-far-mah-KOG-noh-see]	Animal use of natural substances for self-medication.\
zoosemiotics	[zoo-see-mee-OT-iks]	Study of animal communication/sign systems.\
zygote_selection	[ZYE-goht sel-ECK-shun]	Fitness differences acting before or at fertilization.\
zealous_resource_guarding	[ZELL-us REE-sorse GAR-ding]	Intense defensive protection of valued items.\
zone_of_safety	[ZOHN of SAYF-tee]	Subjective spatial buffer that reduces perceived threat.}