{\rtf1\ansi\ansicpg1252\cocoartf2822
\cocoatextscaling0\cocoaplatform0{\fonttbl\f0\fswiss\fcharset0 Helvetica;}
{\colortbl;\red255\green255\blue255;}
{\*\expandedcolortbl;;}
\margl1440\margr1440\vieww11520\viewh8400\viewkind0
\pard\tx720\tx1440\tx2160\tx2880\tx3600\tx4320\tx5040\tx5760\tx6480\tx7200\tx7920\tx8640\pardirnatural\partightenfactor0

\f0\fs24 \cf0 adhabu ya kijamii = ah-THAH-boo yah kee-jah-MEE | Social sanction; imposed communal penalty.\
adhimu = ah-THEE-moo | Rare; exceptional occurrence.\
afua za mazingira = ah-FOO-ah zah mah-zeen-GEE-rah | Environmental interventions.\
aghalabu = ah-GHAH-lah-boo | Frequently; most often.\
akiba ya kitabia = ah-KEE-bah yah kee-tah-BEE-ah | Behavioral reserve/adaptive buffer.\
alama ya mazingira = ah-LAH-mah yah mah-zeen-GEE-rah | Environmental marker/signal.\
algoriti ya maamuzi = al-goh-REE-tee yah mah-ah-MOO-zee | Decision algorithm.\
anthropolojia = an-thro-poh-LOH-jee-ah | Anthropology.\
ashiria ya hatari = ah-SHEER-ee-ah yah hah-TAR-ee | Indicator of risk.\
asili ya tabia = ah-SEE-lee yah tah-BEE-ah | Behavioral origins.\
athari za kijeni = ah-THAH-ree zah kee-JAY-nee | Genetic effects.\
athari za kitabia = ah-THAH-ree zah kee-tah-BEE-ah | Behavioral impacts.\
bainishi = bah-ee-NEE-shee | Distinguishing variable/feature.\
bainifu = bah-ee-NEE-foo | Explicit; clearly articulated.\
banuti za kibiolojia = bah-NOO-tee zah kee-bee-oh-LOH-jee-ah | Biological constraints.\
barakoa ya kijamii = bah-rah-KOH-ah yah kee-jah-MEE | Social mask; performed identity.\
bayometriki = bah-yoh-meh-TREE-kee | Biometric measures.\
bidhaa za kitamaduni = bee-THAH zah kee-tah-mah-DOO-nee | Cultural products/practices.\
biogeografia = bye-oh-jee-oh-grah-FEE-ah | Biogeography.\
bioanuwai = bye-oh-ah-noo-WAH-ee | Biodiversity.\
bioteki = bee-oh-TEH-kee | Biotechnology.\
changamoto za kijamii = chan-gah-MOH-toh zah kee-jah-MEE | Social challenges.\
changamoto za kimaadili = chan-gah-MOH-toh zah kee-mah-AH-dee-lee | Ethical dilemmas.\
changamano = chan-gah-MAH-noh | Complex; multidimensional.\
chochoko ya tabia = cho-CHOH-koh yah tah-BEE-ah | Behavioral priming.\
dhibiti = thih-BEE-tee | Regulate; control precisely.\
dhima ya kijamii = THEE-mah yah kee-jah-MEE | Social function/role.\
dhima ya kiikolojia = THEE-mah yah kee-ee-koh-LOH-jee-ah | Ecological function.\
dhima ya kitabibu = THEE-mah yah kee-tah-BEE-boo | Clinical role/function.\
dhoruba ya kitabia = tho-ROO-bah yah kee-tah-BEE-ah | Behavioral storm; emotional overload.\
dimu ya maumbile = DEE-moo yah mah-oom-BEE-lay | Biological paradigm.\
dira ya kijamii = DEE-rah yah kee-jah-MEE | Social compass; communal direction.\
ekolojia tabia = eh-koh-LOH-jee-ah tah-BEE-ah | Behavioral ecology.\
ekolojia ya kibinadamu = eh-koh-LOH-jee-ah yah kee-bee-nah-MOO | Human ecology.\
endomofolojia = en-doh-moh-foh-LOH-jee-ah | Morphological endocrinology.\
epidemiolojia = eh-pee-deh-mee-oh-LOH-jee-ah | Epidemiology.\
fasihi simulizi = fah-SEE-hee see-moo-LEE-zee | Oral tradition/narrative.\
fadhila ya kijamii = fah-DHEE-lah yah kee-jah-MEE | Prosocial virtuous behavior.\
fadhila ya uongozi = fah-DHEE-lah yah oo-on-GOH-zee | Leadership virtue.\
fanikio la tabia = fah-nee-KEE-oh lah tah-BEE-ah | Behavioral success outcome.\
fadhili = fah-THEE-lee | Compassion; kindness.\
fidia za kitabia = fee-DEE-ah zah kee-tah-BEE-ah | Behavioral compensations.\
fikra za mageuzi = FEEK-rah zah mah-gay-OO-zee | Evolutionary perspectives.\
fomu ya ushirika = FOH-moo yah oo-shee-REE-kah | Cooperative structure.\
fikra changamano = FEEK-rah chan-gah-MAH-noh | Complex cognition.\
genetiki idadi = geh-NEH-tee-kee ee-DAH-dee | Population genetics.\
genomiki = geh-NOH-mee-kee | Genomics.\
geografia kijamii = jee-oh-GRAH-fee-ah kee-jah-MEE | Human social geography.\
gisimu = gee-SEE-moo | Virtual environment (digital).\
hadhi ya kijamii = HAH-thee yah kee-jah-MEE | Social status.\
hali tete ya mazingira = HAH-lee TAY-tay yah mah-zeen-GEE-rah | Environmental fragility.\
hali ya kiutambuzi = HAH-lee yah kee-oo-tam-BOO-zee | Cognitive state.\
hali ya kihemko = HAH-lee yah kee-HEM-koh | Emotional state.\
harakati za kimaumbile = hah-rah-KAH-tee zah kee-mah-oom-BEE-lay | Morphological movements.\
harakati za kijamii = hah-rah-KAH-tee zah kee-jah-MEE | Social movements.\
hekaya ya tabia = heh-KAI-yah yah tah-BEE-ah | Behavioral story/narrative.\
hemaolojia = heh-mah-oh-LOH-jee-ah | Hematology.\
hesabu za takwimu = heh-SAH-boo zah tah-KWEE-moo | Statistical computations.\
hitimisho la utafiti = hee-tee-MEE-shoh lah oo-tah-FEE-tee | Research conclusion.\
huduma za kitabibu = hoo-DOO-mah zah kee-tah-BEE-boo | Clinical services.\
ishara ya kimaumbile = ee-SHAH-rah yah kee-mah-oom-BEE-lay | Morphological marker.\
ishara ya kitabia = ee-SHAH-rah yah kee-tah-BEE-ah | Behavioral signal.\
jadili ya kijamii = jah-DEE-lee yah kee-jah-MEE | Social discourse.\
jadiliano la kitaalamu = jah-dee-LEE-ah-noh lah kee-tah-AH-luh-moo | Technical discussion/analysis.\
jinsia kijamii = jeen-SEE-ah kee-jah-MEE | Gender as a social construct.\
kalibu tabia = kah-LEE-boo tah-BEE-ah | Behavior proximity; behavioral similarity.\
kanuni za mageuzi = kah-NOO-nee zah mah-gay-OO-zee | Principles of evolution.\
kanuni za maadili = kah-NOO-nee zah mah-AH-dee-lee | Ethical principles.\
kazi ya viumbehai = KAH-zee yah vee-oom-BEH-hai | Function of living organisms.\
kelele ya mazingira = keh-LAY-leh yah mah-zeen-GEE-rah | Environmental noise.\
kibali cha utafiti = kee-BAH-lee chah oo-tah-FEE-tee | Research approval.\
kichocheo cha tabia = kee-choh-CHEH-oh chah tah-BEE-ah | Behavioral stimulus.\
kipimo cha kijamii = kee-PEE-moh chah kee-jah-MEE | Social measure/index.\
kisaikolojia = kee-sigh-koh-LOH-jee-ah | Psychological.\
kitaaluma = kee-tah-ah-LOO-mah | Professional/academic.\
kifani-bayolojia = kee-FAH-nee bye-oh-LOH-jee-ah | Biofunctional analysis.\
kuingiliana kitabia = koo-ing-ee-lee-AH-nah kee-tah-BEE-ah | Behavioral interaction.\
kikundi kiutendaji = kee-GOON-dee kee-oo-ten-DAH-jee | Functional group.\
kimuundo = kee-moo-OON-doh | Structural (biological or social).\
kizazi mfuatano = kee-ZAH-zee mfoo-ah-TAH-noh | Sequential generations.\
kiziada = kee-ZEE-ah-dah | Additional/auxiliary.\
kiwanja cha takwimu = kee-WAHN-jah chah tah-KWEE-moo | Statistical field.\
kuzingatia kichocheo = koo-zeen-gah-TEE-ah kee-choh-CHEH-oh | Stimulus focusing.\
maadili ya kijamii = mah-AH-dee-lee yah kee-jah-MEE | Social ethics.\
maana fiche = mah-AH-nah FEE-chay | Hidden meaning.\
maelezo ya kina = mah-eh-LEH-zoh yah KEE-nah | In-depth explanation.\
mafunzo ya kitabia = mah-FOON-zoh yah kee-tah-BEE-ah | Behavioral training.\
mageuzi ya tabia = mah-gay-OO-zee yah tah-BEE-ah | Behavioral evolution.\
matokeo ya kijeni = mah-toh-KAY-oh yah kee-JAY-nee | Genetic outcomes.\
mawasiliano ya kijamii = mah-wah-see-LEE-ah-noh yah kee-jah-MEE | Social communication.\
meanzo ya ikolojia = meh-AN-zoh yah ee-koh-LOH-jee-ah | Ecological origins.\
michango ya kitabia = mee-CHANG-oh yah kee-tah-BEE-ah | Behavioral contributions.\
michoro ya kijamii = mee-CHOH-roh yah kee-jah-MEE | Social diagrams/networks.\
midundo ya kitabia = mee-DOON-doh yah kee-tah-BEE-ah | Behavioral rhythms.\
miundo ya mageuzi = mee-OON-doh yah mah-gay-OO-zee | Evolutionary structures.\
mjadala wa kitaalamu = m-jah-DAH-lah wah kee-tah-AH-luh-moo | Technical debate.\
mkabala wa kitabia = m-kah-BAH-lah wah kee-tah-BEE-ah | Behavioral approach.\
mlingano wa tabia = m-leen-GAH-noh wah tah-BEE-ah | Behavioral equilibrium.\
mnyambuliko wa takwimu = m-nyahm-boo-LEE-koh wah tah-KWEE-moo | Statistical decomposition.\
modeu ya kijamii = moh-DAY-oh yah kee-jah-MEE | Social model.\
mshikamano wa kijamii = mshih-kah-MAH-noh wah kee-jah-MEE | Social cohesion.\
msururu wa mageuzi = m-soo-ROO-roo wah mah-gay-OO-zee | Evolutionary sequence.\
mtaala wa ikolojia = mtah-AH-lah wah ee-koh-LOH-jee-ah | Ecology curriculum.\
mtiririko wa tabia = m-tee-ree-REE-koh wah tah-BEE-ah | Flow of behavior.\
muda muafaka = MOO-dah moo-AH-fah-kah | Appropriate timing.\
muktadha jinsia = MOOK-tah-tha jeen-SEE-ah | Gender context.\
muktadha wa tabia = MOOK-tah-tha wah tah-BEE-ah | Behavioral context.\
mwelekeo wa kihisia = m-weh-leh-KAY-oh wah kee-hee-SEE-ah | Emotional tendency.\
mwelekeo wa kijeni = m-weh-leh-KAY-oh wah kee-JAY-nee | Genetic tendency.\
mwelekeo wa mazingira = m-weh-leh-KAY-oh wah mah-zeen-GEE-rah | Environmental trend.\
nafasi ya kitafiti = nah-FAH-see yah kee-tah-FEE-tee | Research opportunity.\
nguvu za kisaikolojia = NGOO-voo zah kee-sigh-koh-LOH-jee-ah | Psychological forces.\
nishati ya kitabia = nee-SHAH-tee yah kee-tah-BEE-ah | Behavioral energy/output.\
njama ya kijamii = n-JAH-mah yah kee-jah-MEE | Social scheme/strategy.\
nukta ya maamuzi = NOOK-tah yah mah-ah-MOO-zee | Decision point.\
pembejeo ya kitabia = pem-beh-JEH-oh yah kee-tah-BEE-ah | Behavioral input.\
pendekezo la utafiti = pen-deh-KEH-zoh lah oo-tah-FEE-tee | Research proposal.\
pendwa ya kijamii = PEN-dwah yah kee-jah-MEE | Social preference.\
ramani ya kitakwimu = rah-MAH-nee yah kee-tah-KWEE-moo | Statistical map.\
rasimali watu = rah-see-MAH-lee WAH-too | Human resources.\
resiliensi ya kijamii = reh-zee-LEE-en-see yah kee-jah-MEE | Social resilience.\
roho jamii = ROH-hoh jah-MEE | Collective social consciousness.\
sababu ya kitabia = sah-BAH-boo yah kee-tah-BEE-ah | Behavioral cause.\
sampuli ya mkakati = sam-POO-lee yah m-kah-TAH-tee | Strategic sample.\
sayansi ya tabia = sigh-AHN-see yah tah-BEE-ah | Behavioral science.\
sayansi ya mfumohai = sigh-AHN-see yah m-FOOM-oh-hai | Systems biology.\
sekta ya mazingira = SECK-tah yah mah-zeen-GEE-rah | Environmental sector.\
sera za ulinzi = SEH-rah zah oo-LEEN-zee | Protective policies.\
simulizi za kitabia = see-moo-LEE-zee zah kee-tah-BEE-ah | Behavioral narratives.\
stadi ya kijamii = STAH-dee yah kee-jah-MEE | Social study.\
stahili za kijeni = stah-HEE-lee zah kee-JAY-nee | Genetic endowments.\
tabaka la kijamii = tah-BAH-kah lah kee-jah-MEE | Social class.\
tabia bainifu = tah-BEE-ah bah-ee-NEE-foo | Distinctive behavior.\
tabia fuatilizi = tah-BEE-ah foo-ah-tee-LEE-zee | Sequential behavior.\
tafiti za ikolojia = tah-FEE-tee zah ee-koh-LOH-jee-ah | Ecological research.\
takriban kijeni = tak-REE-bahn kee-JAY-nee | Approximate genetic closeness.\
taratibu za kimaadili = tah-rah-TEE-boo zah kee-mah-AH-dee-lee | Moral procedures.\
taswira za kijamii = tahs-WEE-rah zah kee-jah-MEE | Social imagery/stereotypes.\
tekeleza maamuzi = teh-keh-LEH-zah mah-ah-MOO-zee | Execute decisions.\
tilawa ya maumbile = tee-LAH-wah yah mah-oom-BEE-lay | Natural recitation/biological reading.\
tofauti za kijeni = toh-FAH-oo-tee zah kee-JAY-nee | Genetic differences.\
uchambuzi wa kijamii = oo-cham-BOO-zee wah kee-jah-MEE | Social analysis.\
uchambuzi wa kitabia = oo-cham-BOO-zee wah kee-tah-BEE-ah | Behavioral analysis.\
uchanganuzi wa takwimu = oo-chan-gah-NOO-zee wah tah-KWEE-moo | Statistical analytics.\
uchochezi wa tabia = oo-choh-CHEH-zee wah tah-BEE-ah | Behavioral activation.\
udhihirisho wa kijeni = oo-thee-hee-REE-shoh wah kee-JAY-nee | Genetic manifestation.\
udhibiti wa kimetaboli = oo-THEE-bee-tee wah kee-meh-TAH-bo-lee | Metabolic regulation.\
ufafanuzi wa ikolojia = oo-fah-fah-NOO-zee wah ee-koh-LOH-jee-ah | Ecological clarification.\
ufanisi wa tabia = oo-fah-NEE-see wah tah-BEE-ah | Behavioral efficiency.\
ufanisi wa mazingira = oo-fah-NEE-see wah mah-zeen-GEE-rah | Environmental efficiency.\
ufasiri wa kitabia = oo-fah-SEE-ree wah kee-tah-BEE-ah | Behavioral interpretation.\
uamuzi changamano = oo-ah-MOO-zee chan-gah-MAH-noh | Complex decision.\
uamuzi wa kisayansi = oo-ah-MOO-zee wah kee-sigh-AHN-see | Scientific decision.\
uhalisia wa kijamii = oo-hah-LEE-see-ah wah kee-jah-MEE | Social realism.\
ujumuishaji kijamii = oo-joo-moo-EE-shah-jee kee-jah-MEE | Social inclusion.\
ujumuishaji wa takwimu = oo-joo-moo-EE-shah-jee wah tah-KWEE-moo | Statistical integration.\
ukuzaji wa kitabia = oo-koo-ZAH-jee wah kee-tah-BEE-ah | Behavioral development.\
umakinifu wa kijamii = oo-mah-kee-NEE-foo wah kee-jah-MEE | Social attentiveness.\
umakinifu wa kitabia = oo-mah-kee-NEE-foo wah kee-tah-BEE-ah | Behavioral attentiveness.\
umuhimu wa kijeni = oo-moo-HEE-moo wah kee-JAY-nee | Genetic significance.\
unene wa kitakwimu = oo-NAY-nay wah kee-tah-KWEE-moo | Statistical weight.\
unene wa tabia = oo-NAY-nay wah tah-BEE-ah | Behavioral weight.\
unene wa mazingira = oo-NAY-nay wah mah-zeen-GEE-rah | Environmental density.\
upendeleo wa kijamii = oo-pen-DAY-loh wah kee-jah-MEE | Social bias.\
upendeleo wa kitabia = oo-pen-DAY-loh wah kee-tah-BEE-ah | Behavioral bias.\
upimaji wa mazingira = oo-pee-MAH-jee wah mah-zeen-GEE-rah | Environmental assessment.\
upimaji wa tabia = oo-pee-MAH-jee wah tah-BEE-ah | Behavioral assessment.\
urazini kijamii = oo-rah-ZEE-nee kee-jah-MEE | Social reasoning.\
urazini wa tabia = oo-rah-ZEE-nee wah tah-BEE-ah | Behavioral reasoning.\
utafiti wa mageuzi = oo-tah-FEE-tee wah mah-gay-OO-zee | Evolutionary research.\
utambuzi wa mazingira = oo-tam-BOO-zee wah mah-zeen-GEE-rah | Environmental cognition.\
utambuzi wa tabia = oo-tam-BOO-zee wah tah-BEE-ah | Behavioral cognition.\
utandawazi kijamii = oo-tahn-dah-WAH-zee kee-jah-MEE | Social globalization.\
utata wa kijamii = oo-TAH-tah wah kee-jah-MEE | Social ambiguity.\
utata wa kitabia = oo-TAH-tah wah kee-tah-BEE-ah | Behavioral ambiguity.\
utegemezi kitabia = oo-teg-eh-MEH-zee kee-tah-BEE-ah | Behavioral dependence.\
utendaji kimaumbile = oo-ten-DAH-jee kee-mah-oom-BEE-lay | Functional morphology.\
utendaji wa kijamii = oo-ten-DAH-jee wah kee-jah-MEE | Social functioning.\
utendaji wa tabia = oo-ten-DAH-jee wah tah-BEE-ah | Behavioral functioning.\
utoaji wa kitabia = oo-toh-AH-jee wah kee-tah-BEE-ah | Behavioral output.\
utoaji wa mazingira = oo-toh-AH-jee wah mah-zeen-GEE-rah | Environmental output.\
utaratibu wa kijamii = oo-tah-rah-TEE-boo wah kee-jah-MEE | Social mechanism.\
utata wa kijeni = oo-TAH-tah wah kee-JAY-nee | Genetic ambiguity.\
uvukaji wa vizazi = oo-voo-KAH-jee wah vee-ZAH-zee | Transgenerational passage.\
uwiano wa kijamii = oo-wee-AH-noh wah kee-jah-MEE | Social correlation.\
uwiano wa mazingira = oo-wee-AH-noh wah mah-zeen-GEE-rah | Ecological correlation.\
uzingatiaji kijamii = oo-zeen-gah-TEE-ah-jee kee-jah-MEE | Social attention/compliance.\
uzingatiaji kitabia = oo-zeen-gah-TEE-ah-jee kee-tah-BEE-ah | Behavioral compliance.\
uzingatiaji wa ikolojia = oo-zeen-gah-TEE-ah-jee wah ee-koh-LOH-jee-ah | Ecological compliance.\
uzuiaji wa mazingira = oo-zoo-EE-ah-jee wah mah-zeen-GEE-rah | Environmental prevention/mitigation.\
uzuiaji wa tabia = oo-zoo-EE-ah-jee wah tah-BEE-ah | Behavioral inhibition/prevention.\
uzoefu wa kijamii = oo-zoh-EH-foo wah kee-jah-MEE | Social experience.\
uzoefu wa kitabia = oo-zoh-EH-foo wah kee-tah-BEE-ah | Behavioral experience.\
}