{\rtf1\ansi\ansicpg1252\cocoartf2822
\cocoatextscaling0\cocoaplatform0{\fonttbl\f0\fswiss\fcharset0 Helvetica;}
{\colortbl;\red255\green255\blue255;}
{\*\expandedcolortbl;;}
\margl1440\margr1440\vieww11520\viewh8400\viewkind0
\pard\tx720\tx1440\tx2160\tx2880\tx3600\tx4320\tx5040\tx5760\tx6480\tx7200\tx7920\tx8640\pardirnatural\qj\partightenfactor0

\f0\fs24 \cf0 acha = AH-chah | Stop; cease an action.\
afya = AH-fyah | Health; wellness.\
angalifu = an-gah-LEE-foo | Careful; cautious.\
asante = ah-SAHN-tay | Thank you.\
bahari = bah-HAH-ree | Ocean; sea.\
barabara = bah-rah-BAH-rah | Road.\
chakula = cha-KOO-lah | Food.\
chafu = CHAH-foo | Dirty; unclean.\
daktari = dahk-TAH-ree | Doctor.\
dala dala = dah-lah DAH-lah | Shared public minibus.\
daraja = dah-RAH-jah | Bridge.\
differences = dee-FEH-ren-seh | Not similar; distinction.\
duka = DOO-kah | Small shop.\
elimu = eh-LEE-moo | Education; knowledge.\
fisi = FEE-see | Hyena.\
gari = GAH-ree | Car; vehicle.\
habari = hah-BAH-ree | How are you?/News?\
hakuna = hah-KOO-nah | There is none; no problem.\
hali = HAH-lee | Condition; state.\
hatari = hah-TAR-ee | Danger.\
hewa = HEH-wah | Air; breeze.\
homa = HOH-mah | Fever.\
huduma = hoo-DOO-mah | Service; assistance.\
ishi = EE-shee | Live; reside.\
jamii = jah-MEE | Community; society.\
jambo = JAHM-boh | Hello.\
jaribio = jah-ree-BEE-oh | Attempt; trial.\
jitihada = jee-tee-HAH-dah | Effort.\
jiwe = JEE-way | Stone; rock.\
kadi = KAH-dee | Card; ID card.\
kahawa = kah-HAH-wah | Coffee.\
kajiji = kah-JEE-jee | Settlement; little village.\
kalamu = kah-LAH-moo | Pen.\
kazi = KAH-zee | Work; job.\
kibanda = kee-BAHN-dah | Small hut/shop stand.\
kichaka = kee-CHAH-kah | Bush; shrub area.\
kijana = kee-JAH-nah | Young person.\
kijiji = kee-JEE-jee | Village.\
kilimo = kee-LEE-moh | Agriculture; farming.\
kituo = kee-TOO-oh | Station or stop.\
kizuizi = kee-zoo-EE-zee | Barrier; restriction.\
labda = LAB-dah | Maybe; perhaps.\
lengo = LENG-oh | Goal; objective.\
lishe = LEE-sheh | Nutrition.\
mafundi = mah-FOON-dee | Skilled laborers; technicians.\
maji = MAH-jee | Water.\
maziwa = mah-ZEE-wah | Milk.\
mbinu = M-BEE-noo | Technique; method.\
mboga = M-BOH-gah | Vegetables.\
mbwa = MM-bwah | Dog.\
mchanga = m-CHANG-ah | Sand.\
mchoraji = m-choh-RAH-jee | Illustrator; drawer.\
mfalme = m-FAHL-meh | Leader; king.\
mgambo = m-GAM-boh | Local security/response team.\
mgonjwa = m-GON-jwah | Sick person.\
mkono = m-KOH-noh | Arm/hand.\
mlango = m-LANG-oh | Door.\
mnyama = m-NYAH-mah | Animal.\
moto = MOH-toh | Fire; heat.\
moyo = MOY-oh | Heart.\
mto = mm-TOH | River.\
mvuvi = m-VOO-vee | Fisherman.\
mwenendo = mwen-EN-doh | Behavior; conduct.\
nafasi = nah-FAH-see | Space; opportunity.\
ngoma = ng-OH-mah | Drum; celebration.\
nguvu = NGOO-voo | Strength; power.\
njia = n-JEE-ah | Path; way.\
nukuu = noo-KOO | Quote; citation.\
pamoja = pah-MOH-jah | Together.\
panya = PAHN-yah | Rat.\
picha = PEE-chah | Picture; image.\
pikipiki = pee-kee-PEE-kee | Motorcycle.\
pole = POH-lay | Sorry.\
pole pole = POH-lay POH-lay | Slowly.\
punda = POON-dah | Donkey.\
rafiki = rah-FEE-kee | Friend.\
sababu = sah-BAH-boo | Reason.\
salama = sah-LAH-mah | Safe.\
sambamba = sahm-BAHM-bah | Parallel; aligned.\
safari = sah-FAR-ee | Journey.\
samaki = sah-MAH-kee | Fish.\
sanduku = san-DOO-koo | Box.\
shamba = SHAM-bah | Field/farm.\
shule = SHOO-lay | School.\
simu = SEE-moo | Phone.\
soko = SOH-koh | Marketplace.\
taaluma = tah-ah-LOO-mah | Profession; academic field.\
taifa = tah-EE-fah | Nation.\
taimu = TIE-moo | Time (colloquial).\
takataka = tah-kah-TAH-kah | Trash; waste.\
tamasha = tah-MAH-shah | Festival; event.\
tawila = tah-WEE-lah | Table/desk.\
tembea = tem-BEH-ah | Walk.\
tumbo = TOOM-boh | Stomach.\
twende = TWEN-day | Let's go.\
ugali = oo-GAH-lee | Staple food (maize).\
ukoo = oo-KOH | Family lineage/clan.\
upepo = oo-PEH-poh | Wind.\
wakati = wah-KAH-tee | Time/period.\
wakazi = wah-KAH-zee | Residents.\
wazi = WAH-zee | Open; transparent.\
wia = WEE-ah | To fail; be unable.\
zawadi = zah-WAH-dee | Gift.\
}